id,release_date,movie,production_budget,domestic_gross,worldwide_gross,revenue,profit,roi,release_year,release_month
1,1959-07-18,The Nun's Story,3500000,12800000,12800000,25600000,22100000,6.314285714285714,1959,7
1,1962-06-13,Lolita,2000000,9250000,9250000,18500000,16500000,8.25,1962,6
1,1974-02-07,Blazing Saddles,2600000,119500000,119500000,239000000,236400000,90.92307692307692,1974,2
1,1978-06-16,Jaws 2,20000000,102922376,208900376,311822752,291822752,14.5911376,1978,6
1,1980-11-14,Raging Bull,18000000,23380203,23380203,46760406,28760406,1.5978003333333333,1980,11
1,1981-03-20,The Postman Always Rings Twice,12000000,12200000,44200000,56400000,44400000,3.7,1981,3
1,1981-04-10,Nighthawks,5000000,14600000,19600000,34200000,29200000,5.84,1981,4
1,1987-06-24,Spaceballs,22700000,38119483,38119483,76238966,53538966,2.358544757709251,1987,6
1,1989-09-22,Black Rain,30000000,45892212,45892212,91784424,61784424,2.0594808,1989,9
1,1990-09-19,Goodfellas,25000000,46743809,46777347,93521156,68521156,2.74084624,1990,9
1,1993-04-23,The Dark Half,15000000,9579068,9579068,19158136,4158136,0.27720906666666667,1993,4
1,1995-05-12,Crimson Tide,55000000,91387195,159387195,250774390,195774390,3.5595343636363634,1995,5
1,1996-12-20,Scream,15000000,103046663,173046663,276093326,261093326,17.406221733333332,1996,12
1,1997-11-26,Alien: Resurrection,60000000,47795018,160700000,208495018,148495018,2.4749169666666666,1997,11
1,1998-08-21,Dead Man on Campus,14000000,15064948,15064948,30129896,16129896,1.1521354285714285,1998,8
1,1999-07-16,Lake Placid,27000000,31770413,31770413,63540826,36540826,1.353363925925926,1999,7
1,2000-03-01,3 Strikes,4000000,9821335,9821335,19642670,15642670,3.9106675,2000,3
1,2000-03-03,What Planet Are You From?,50000000,6291602,6291602,12583204,-37416796,-0.74833592,2000,3
1,2000-09-29,Beautiful,9000000,3134509,3134509,6269018,-2730982,-0.30344244444444446,2000,9
1,2002-02-01,Slackers,11000000,4814244,5942218,10756462,-243538,-0.02213981818181818,2002,2
1,2002-03-22,Stolen Summer,1500000,119841,119841,239682,-1260318,-0.840212,2002,3
1,2002-10-11,Swept Away,10000000,598645,598645,1197290,-8802710,-0.880271,2002,10
1,2003-05-14,Dracula: Pages from a Virgin's Diary,1100000,39659,81371,121030,-978970,-0.8899727272727272,2003,5
1,2003-11-26,Timeline,80000000,19480739,26703184,46183923,-33816077,-0.4227009625,2003,11
1,2004-03-26,Jersey Girl,35000000,25266129,37066129,62332258,27332258,0.7809216571428571,2004,3
1,2005-12-07,The World's Fastest Indian,25000000,5128124,18991288,24119412,-880588,-0.03522352,2005,12
1,2006-04-21,American Dreamz,17000000,7314027,16510971,23824998,6824998,0.4014704705882353,2006,4
1,2006-08-04,The Descent,7000000,26024456,57051053,83075509,76075509,10.867929857142856,2006,8
1,2007-06-08,Ocean's Thirteen,85000000,117144465,311744465,428888930,343888930,4.0457521176470586,2007,6
1,2007-06-15,DOA: Dead or Alive,30000000,480314,7755686,8236000,-21764000,-0.7254666666666667,2007,6
1,2007-09-21,Into the Wild,20000000,18354356,56822960,75177316,55177316,2.7588658,2007,9
1,2008-05-30,The Foot Fist Way,79000,234286,234286,468572,389572,4.931291139240506,2008,5
1,2008-07-18,Space Chimps,37000000,30105968,67029956,97135924,60135924,1.6252952432432433,2008,7
1,2008-12-19,Yes Man,50000000,97690976,225990976,323681952,273681952,5.47363904,2008,12
1,2008-12-26,Revolutionary Road,45000000,22951340,79604820,102556160,57556160,1.2790257777777778,2008,12
1,2009-05-29,Up,175000000,293004164,731463377,1024467541,849467541,4.854100234285714,2009,5
1,2009-07-31,The Collector,3000000,7712114,10473836,18185950,15185950,5.061983333333333,2009,7
1,2009-08-21,Inglourious Basterds,70000000,120774594,316915264,437689858,367689858,5.252712257142857,2009,8
1,2009-11-13,The Messenger,6500000,1109660,1744952,2854612,-3645388,-0.5608289230769231,2009,11
1,2009-12-18,Avatar,425000000,760507625,-1518622017,-758114392,-1183114392,-2.783798569411765,2009,12
1,2010-02-26,Un ProphÃ¨te,13000000,2087720,19910624,21998344,8998344,0.6921803076923077,2010,2
1,2010-10-08,It's Kind of a Funny Story,8000000,6363628,6632950,12996578,4996578,0.62457225,2010,10
1,2010-12-10,The Tempest,20000000,277943,277943,555886,-19444114,-0.9722057,2010,12
1,2010-12-17,How Do You Know?,120000000,30212620,49628177,79840797,-40159203,-0.334660025,2010,12
1,2011-02-18,"Big Mommas: Like Father, Like Son",32000000,37915414,82332450,120247864,88247864,2.75774575,2011,2
1,2011-03-18,Winter in Wartime,5800000,542860,9662214,10205074,4405074,0.7594955172413793,2011,3
1,2012-03-09,A Thousand Words,40000000,18450127,20790486,39240613,-759387,-0.018984675,2012,3
1,2012-11-21,Red Dawn,65000000,44806783,48164150,92970933,27970933,0.43032204615384617,2012,11
1,2014-03-07,Mr. Peabody & Sherman,145000000,111506430,269806430,381312860,236312860,1.6297438620689655,2014,3
1,2014-11-14,Dumb and Dumber To,40000000,86208010,156553592,242761602,202761602,5.06904005,2014,11
1,2015-01-23,Mommy,4900000,3498695,17536004,21034699,16134699,3.2927957142857145,2015,1
1,2015-12-11,In the Heart of the Sea,100000000,25020758,89693309,114714067,14714067,0.14714067,2015,12
1,2016-09-16,Blair Witch,10000000,20777061,38985577,59762638,49762638,4.9762638,2016,9
1,2018-12-14,That Way Madness Lies,650000,1447,1447,2894,-647106,-0.9955476923076924,2018,12
2,1940-08-30,Boom Town,2000000,9172000,9172000,18344000,16344000,8.172,1940,8
2,1972-06-21,Frenzy,3500000,12600000,12600000,25200000,21700000,6.2,1972,6
2,1983-10-21,The Dead Zone,10000000,20766000,20766000,41532000,31532000,3.1532,1983,10
2,1984-04-13,Friday the 13th Part IV: The Final Chapter,2600000,32980880,32980880,65961760,63361760,24.36990769230769,1984,4
2,1987-06-26,Full Metal Jacket,30000000,45015999,45015999,90031998,60031998,2.0010666,1987,6
2,1988-07-08,Phantasm II,3000000,7282851,7282851,14565702,11565702,3.855234,1988,7
2,1989-07-28,Friday the 13th Part VIII: Jason Takes Manhattan,5000000,14343976,14343976,28687952,23687952,4.7375904,1989,7
2,1991-12-11,Hook,70000000,119654823,300854823,420509646,350509646,5.007280657142857,1991,12
2,1993-01-15,Alive,32000000,36299670,36299670,72599340,40599340,1.268729375,1993,1
2,1995-08-25,Desperado,7000000,25532388,25532388,51064776,44064776,6.294968,1995,8
2,1996-05-03,The Pallbearer,8000000,5656388,5656388,11312776,3312776,0.414097,1996,5
2,1997-11-21,Midnight in the Garden of Good and Evil,35000000,25078937,25078937,50157874,15157874,0.4330821142857143,1997,11
2,1998-09-11,Simon Birch,20000000,18253415,18310591,36564006,16564006,0.8282003,1998,9
2,1999-05-14,Tea with Mussolini,14000000,14395874,14395874,28791748,14791748,1.0565534285714286,1999,5
2,1999-12-17,Magnolia,37000000,22450975,48446802,70897777,33897777,0.9161561351351352,1999,12
2,2003-09-26,The Gospel of John,11000000,4068087,4234355,8302442,-2697558,-0.24523254545454545,2003,9
2,2003-10-03,Foolproof,5800000,230312,421021,651333,-5148667,-0.8877012068965517,2003,10
2,2003-12-12,Girl with a Pearl Earring,12000000,11634362,43274797,54909159,42909159,3.57576325,2003,12
2,2004-07-23,A Home at the End of the World,6500000,1029017,1033810,2062827,-4437173,-0.682642,2004,7
2,2005-09-23,Flightplan,55000000,89706988,214392904,304099892,249099892,4.5290889454545455,2005,9
2,2006-04-07,Lucky Number Slevin,27000000,22495466,55495466,77990932,50990932,1.8885530370370371,2006,4
2,2006-10-20,Marie Antoinette,40000000,15962471,60862471,76824942,36824942,0.92062355,2006,10
2,2006-12-22,We Are Marshall,65000000,43545364,43545364,87090728,22090728,0.33985735384615384,2006,12
2,2007-03-02,Black Snake Moan,15000000,9396870,10951153,20348023,5348023,0.35653486666666667,2007,3
2,2007-03-23,Shooter,60000000,47003582,95538560,142542142,82542142,1.3757023666666666,2007,3
2,2007-06-01,Gracie,9000000,2956339,3922043,6878382,-2121618,-0.23573533333333332,2007,6
2,2007-06-22,1408,22500000,71985628,131263370,203248998,180748998,8.0332888,2007,6
2,2008-01-25,How She Move,17000000,7070641,8607815,15678456,-1321544,-0.07773788235294117,2008,1
2,2008-03-07,é·æ±ä¸è (CJ7),20000000,206678,47300771,47507449,27507449,1.37537245,2008,3
2,2008-04-11,The Visitor,4000000,9427026,19174817,28601843,24601843,6.15046075,2008,4
2,2008-04-25,Deception,25000000,4598506,12850033,17448539,-7551461,-0.30205844,2008,4
2,2008-05-23,"War, Inc.",10000000,580862,1299855,1880717,-8119283,-0.8119283,2008,5
2,2008-08-29,Obsluhoval jsem anglickÃ©ho krÃ¡le,4900000,617228,7174984,7792212,2892212,0.5902473469387756,2008,8
2,2008-08-29,Babylon A.D.,45000000,22532572,70216497,92749069,47749069,1.0610904222222222,2008,8
2,2008-10-03,Beverly Hills Chihuahua,20000000,94514402,154218168,248732570,228732570,11.4366285,2008,10
2,2009-09-18,Love Happens,18000000,22965110,36133014,59098124,41098124,2.283229111111111,2009,9
2,2009-12-25,Itâs Complicated,85000000,112735375,224614744,337350119,252350119,2.9688249294117646,2009,12
2,2010-02-19,Le Petit Nicolas,30000000,201857,52339566,52541423,22541423,0.7513807666666666,2010,2
2,2010-04-22,Oceans,80000000,19422319,86787530,106209849,26209849,0.3276231125,2010,4
2,2010-06-23,Knight and Day,117000000,76423035,258751370,335174405,218174405,1.8647385042735043,2010,6
2,2010-09-24,Buried,1987650,1044143,21270290,22314433,20326783,10.22654038688904,2010,9
2,2010-12-03,"I Love You, Phillip Morris",13000000,2037459,23014027,25051486,12051486,0.9270373846153847,2010,12
2,2011-05-20,Pirates of the Caribbean: On Stranger Tides,410600000,241063875,1045663875,1286727750,876127750,2.13377435460302,2011,5
2,2012-11-21,Rise of the Guardians,145000000,103412758,306900902,410313660,265313660,1.8297493793103448,2012,11
2,2014-02-28,Non-Stop,50000000,91742160,222383055,314125215,264125215,5.2825043,2014,2
2,2014-04-18,Transcendence,100000000,23022309,103039258,126061567,26061567,0.26061567,2014,4
2,2014-04-25,The Other Woman,40000000,83911193,195111193,279022386,239022386,5.97555965,2014,4
2,2014-08-15,The Giver,25000000,45090374,66540205,111630579,86630579,3.46522316,2014,8
2,2014-11-21,The Sleepwalker,1100000,2636,2636,5272,-1094728,-0.9952072727272727,2014,11
2,2015-03-06,Road Hard,1500000,113169,113169,226338,-1273662,-0.849108,2015,3
2,2015-04-17,Child 44,50000000,1224330,8004221,9228551,-40771449,-0.81542898,2015,4
2,2015-07-17,Dawn of the Crescent Moon,75000,8799,8799,17598,-57402,-0.76536,2015,7
2,2017-08-11,Annabelle: Creation,15000000,102092201,305384865,407477066,392477066,26.165137733333335,2017,8
2,2017-11-22,Coco,175000000,209726015,798008101,1007734116,832734116,4.758480662857143,2017,11
3,1933-03-09,42nd Street,439000,1438000,2281000,3719000,3280000,7.471526195899772,1933,3
3,1947-11-11,Gentleman's Agreement,2000000,7800000,7800000,15600000,13600000,6.8,1947,11
3,1966-02-23,Harper,3500000,12000000,12000000,24000000,20500000,5.857142857142857,1966,2
3,1976-01-01,Logan's Run,7000000,25000000,25000000,50000000,43000000,6.142857142857143,1976,1
3,1977-06-22,"New York, New York",14000000,13800000,13800000,27600000,13600000,0.9714285714285714,1977,6
3,1982-02-10,Das Boot,12000000,11487676,84970337,96458013,84458013,7.03816775,1982,2
3,1983-10-21,The Right Stuff,27000000,21500000,21500000,43000000,16000000,0.5925925925925926,1983,10
3,1983-12-09,Scarface,25000000,44942821,44942821,89885642,64885642,2.59542568,1983,12
3,1990-07-03,Die Hard 2,70000000,117323878,239814025,357137903,287137903,4.101970042857143,1990,7
3,1992-11-13,Bram Stoker's Dracula,40000000,82522790,215862692,298385482,258385482,6.45963705,1992,11
3,1994-11-04,Frankenstein,45000000,22006296,112006296,134012592,89012592,1.9780576,1994,11
3,1994-12-09,Disclosure,55000000,83015089,212200000,295215089,240215089,4.367547072727273,1994,12
3,1995-03-01,Tank Girl,25000000,4064333,4064333,8128666,-16871334,-0.67485336,1995,3
3,1998-10-16,Practical Magic,60000000,46850558,68336997,115187555,55187555,0.9197925833333334,1998,10
3,1998-11-20,Enemy of the State,85000000,111549836,250649836,362199672,277199672,3.2611726117647057,1998,11
3,1998-11-25,Babe: Pig in the City,80000000,18319860,69131860,87451720,7451720,0.0931465,1998,11
3,1998-12-25,Stepmom,50000000,91137662,159745279,250882941,200882941,4.01765882,1998,12
3,2000-09-22,Woman on Top,8000000,5018450,10192613,15211063,7211063,0.901382875,2000,9
3,2000-10-06,Get Carter,40000000,14967182,19417182,34384364,-5615636,-0.1403909,2000,10
3,2001-02-02,Valentine,10000000,20384136,20384136,40768272,30768272,3.0768272,2001,2
3,2001-08-17,Aberdeen,6500000,64148,64148,128296,-6371704,-0.9802621538461539,2001,8
3,2003-02-21,Dark Blue,15000000,9237470,12262065,21499535,6499535,0.43330233333333334,2003,2
3,2003-11-26,The Cooler,4000000,8291572,11131455,19423027,15423027,3.85575675,2003,11
3,2004-04-02,Shaolin Soccer,10000000,488872,42776032,43264904,33264904,3.3264904,2004,4
3,2004-10-10,Vera Drake,11000000,3753806,13353855,17107661,6107661,0.5552419090909091,2004,10
3,2005-02-11,Pooh's Heffalump Movie,20000000,18098433,55686944,73785377,53785377,2.68926885,2005,2
3,2005-02-18,Son of the Mask,100000000,17018422,59918422,76936844,-23063156,-0.23063156,2005,2
3,2005-04-08,Sahara,145000000,68671925,121671925,190343850,45343850,0.3127162068965517,2005,4
3,2005-09-28,Forty Shades of Blue,1500000,75828,172569,248397,-1251603,-0.834402,2005,9
3,2006-02-24,Running Scared,17000000,6855137,9729088,16584225,-415775,-0.024457352941176472,2006,2
3,2007-02-23,The Number 23,32000000,35193167,77593167,112786334,80786334,2.5245729375,2007,2
3,2009-01-23,Outlander,50000000,166003,1250617,1416620,-48583380,-0.9716676,2009,1
3,2009-09-18,The Burning Plain,20000000,200730,1167092,1367822,-18632178,-0.9316089,2009,9
3,2009-09-25,Fame,18000000,22455510,80227619,102683129,84683129,4.704618277777778,2009,9
3,2010-08-20,Soul Kitchen,4900000,276901,23347461,23624362,18724362,3.8212983673469387,2010,8
3,2011-10-07,Xinhai geming,30000000,135739,8593154,8728893,-21271107,-0.7090369,2011,10
3,2012-10-05,Trade of Innocents,5800000,15091,15091,30182,-5769818,-0.9947962068965517,2012,10
3,2013-03-15,Spring Breakers,5000000,14124286,31149251,45273537,40273537,8.0547074,2013,3
3,2013-03-22,The Sapphires,9000000,2450867,20395040,22845907,13845907,1.538434111111111,2013,3
3,2013-10-25,Jackass Presents: Bad Grandpa,15000000,102003019,160903019,262906038,247906038,16.5270692,2013,10
3,2014-05-02,Ida,2600000,3827060,15298355,19125415,16525415,6.355928846153846,2014,5
3,2014-07-02,Tammy,20000000,84525432,96407655,180933087,160933087,8.04665435,2014,7
3,2015-05-29,Aloha,37000000,21052030,25387091,46439121,9439121,0.2551113783783784,2015,5
3,2015-07-24,The Vatican Tapes,13000000,1784763,14929184,16713947,3713947,0.2856882307692308,2015,7
3,2015-09-18,Everest,65000000,43482270,221297061,264779331,199779331,3.0735281692307694,2015,9
3,2016-09-16,Bridget Jonesâs Baby,35000000,24139805,205822688,229962493,194962493,5.570356942857143,2016,9
3,2016-11-18,Nocturnal Animals,22500000,10663357,32398681,43062038,20562038,0.9138683555555556,2016,11
3,2017-10-27,Let There Be Light,3000000,7233471,7241309,14474780,11474780,3.824926666666667,2017,10
3,2018-01-19,Den of Thieves,30000000,44947622,80131391,125079013,95079013,3.1693004333333334,2018,1
3,2018-10-05,Venom,116000000,213511408,853628605,1067140013,951140013,8.199482870689655,2018,10
3,2018-11-21,Ralph Breaks The Internet,175000000,201091711,524283695,725375406,550375406,3.14500232,2018,11
3,2019-06-07,Dark Phoenix,350000000,42762350,149762350,192524700,-157475300,-0.4499294285714286,2019,6
4,1961-02-01,The Misfits,4000000,8200000,8200000,16400000,12400000,3.1,1961,2
4,1961-09-25,The Hustler,2000000,7600000,7600000,15200000,13200000,6.6,1961,9
4,1978-06-28,Heaven Can Wait,15000000,98800000,98800000,197600000,182600000,12.173333333333334,1978,6
4,1979-12-14,1941,32000000,34175000,94875000,129050000,97050000,3.0328125,1979,12
4,1984-07-20,Die Unendliche Geschichte,27000000,21300000,21392049,42692049,15692049,0.581187,1984,7
4,1987-01-01,Maurice,2600000,3147950,3198308,6346258,3746258,1.4408684615384615,1987,1
4,1987-05-08,River's Edge,1900000,4600000,4600000,9200000,7300000,3.8421052631578947,1987,5
4,1990-08-03,Metropolitan,430000,2938000,2938000,5876000,5446000,12.665116279069768,1990,8
4,1995-04-21,Kiss of Death,40000000,14942422,14942422,29884844,-10115156,-0.2528789,1995,4
4,1996-10-04,The Glimmer Man,45000000,20404841,36404841,56809682,11809682,0.26243737777777776,1996,10
4,1997-07-18,Nothing To Lose,25000000,44480039,64594061,109074100,84074100,3.362964,1997,7
4,1997-12-25,The Postman,80000000,17650704,20841123,38491827,-41508173,-0.5188521625,1997,12
4,1998-03-27,Les Couloirs du temps: Les visiteurs 2,20000000,146072,26146072,26292144,6292144,0.3146072,1998,3
4,1998-04-10,City of Angels,55000000,78750909,198750909,277501818,222501818,4.0454876,1998,4
4,1998-05-27,I Got the Hook-Up!,3500000,10317779,10317779,20635558,17135558,4.895873714285714,1998,5
4,1999-05-19,Star Wars Ep. I: The Phantom Menace,115000000,474544677,1027044677,1501589354,1386589354,12.057298730434782,1999,5
4,2000-05-12,Held Up,8000000,4714090,4714090,9428180,1428180,0.1785225,2000,5
4,2001-11-09,Heist,35000000,23483357,28906817,52390174,17390174,0.4968621142857143,2001,11
4,2002-04-26,Jason X,14000000,13121555,16951798,30073353,16073353,1.1480966428571429,2002,4
4,2003-01-31,The Guru,11000000,3051221,24150550,27201771,16201771,1.4728882727272727,2003,1
4,2003-08-08,S.W.A.T.,70000000,116877597,207154748,324032345,254032345,3.6290335,2003,8
4,2004-08-27,The Brown Bunny,10000000,366301,630427,996728,-9003272,-0.9003272,2004,8
4,2005-01-21,Are We There Yet?,20000000,82674398,98114471,180788869,160788869,8.03944345,2005,1
4,2005-04-22,King's Ransom,25000000,4008527,4049527,8058054,-16941946,-0.67767784,2005,4
4,2006-02-17,Eight Below,40000000,81612565,120455994,202068559,162068559,4.051713975,2006,2
4,2006-03-17,Find Me Guilty,13000000,1173673,2898225,4071898,-8928102,-0.6867770769230769,2006,3
4,2006-04-07,Phat Girlz,3000000,7061128,7301115,14362243,11362243,3.7874143333333334,2006,4
4,2006-06-09,A Prairie Home Companion,10000000,20342852,26716191,47059043,37059043,3.7059043,2006,6
4,2006-09-08,Tom yum goong,5700000,12044087,43044087,55088174,49388174,8.664591929824562,2006,9
4,2006-09-29,School for Scoundrels,20000000,17807569,17807569,35615138,15615138,0.7807569,2006,9
4,2006-09-29,Open Season,85000000,85105259,191932158,277037417,192037417,2.2592637294117646,2006,9
4,2007-06-22,A Mighty Heart,15000000,9176787,19153568,28330355,13330355,0.8886903333333334,2007,6
4,2008-02-21,Genghis Khan: To the Ends of the Earth and Sea,30000000,3892,4874498,4878390,-25121610,-0.837387,2008,2
4,2009-03-27,Monsters vs. Aliens,175000000,198351526,381687380,580038906,405038906,2.3145080342857143,2009,3
4,2009-10-09,Trucker,1500000,52429,52429,104858,-1395142,-0.9300946666666666,2009,10
4,2012-04-13,The Three Stooges,30000000,44338224,54052249,98390473,68390473,2.2796824333333334,2012,4
4,2012-08-17,The Awakening,4900000,95933,6924321,7020254,2120254,0.43270489795918365,2012,8
4,2012-08-24,The Apparition,17000000,4936819,10637281,15574100,-1425900,-0.08387647058823529,2012,8
4,2012-09-14,Resident Evil: Retribution,65000000,42345531,240647629,282993160,217993160,3.353740923076923,2012,9
4,2013-01-11,Gangster Squad,60000000,46000903,104100903,150101806,90101806,1.5016967666666667,2013,1
4,2013-03-15,Upside Down,50000000,102118,26387039,26489157,-23510843,-0.47021686,2013,3
4,2013-08-09,Disney Planes,50000000,90282580,238059569,328342149,278342149,5.56684298,2013,8
4,2014-07-25,Happy Christmas,70000,30312,30312,60624,-9376,-0.13394285714285714,2014,7
4,2015-04-24,The Water Diviner,22500000,4200117,31054727,35254844,12754844,0.5668819555555555,2015,4
4,2015-05-01,Avengers: Age of Ultron,330600000,459005868,1403013963,1862019831,1531419831,4.63224389292196,2015,5
4,2016-07-15,Ghostbusters,144000000,128350574,229008658,357359232,213359232,1.4816613333333333,2016,7
4,2016-08-26,Greater,9000000,2000093,2000093,4000186,-4999814,-0.5555348888888889,2016,8
4,2017-04-07,Gifted,7000000,24801212,36964656,61765868,54765868,7.823695428571429,2017,4
4,2017-04-21,Unforgettable,12000000,11368012,16221211,27589223,15589223,1.2991019166666666,2017,4
4,2017-04-28,The Circle,18000000,20497844,40651864,61149708,43149708,2.397206,2017,4
4,2017-06-09,It Comes at Night,5000000,13985117,19720203,33705320,28705320,5.741064,2017,6
4,2018-12-14,Mortal Engines,100000000,15951040,85287417,101238457,1238457,0.01238457,2018,12
5,1983-09-30,Brainstorm,15000000,8921050,8921050,17842100,2842100,0.18947333333333333,1983,9
5,1984-10-26,The Terminator,6400000,38019031,78019031,116038062,109638062,17.1309471875,1984,10
5,1985-12-04,Young Sherlock Holmes,18000000,19739000,19739000,39478000,21478000,1.1932222222222222,1985,12
5,1985-12-18,The Color Purple,15000000,93589701,93589701,187179402,172179402,11.4786268,1985,12
5,1986-12-31,Witchboard,2000000,7369373,7369373,14738746,12738746,6.369373,1986,12
5,1987-11-20,The Last Emperor,25000000,43984987,44005073,87990060,62990060,2.5196024,1987,11
5,1990-07-13,Ghost,22000000,217631306,517600000,735231306,713231306,32.41960481818182,1990,7
5,1992-12-25,Hoffa,35000000,23365858,28391473,51757331,16757331,0.47878088571428573,1992,12
5,1993-05-14,Excessive Force,13000000,1152117,1152117,2304234,-10695766,-0.8227512307692307,1993,5
5,1994-05-13,Crooklyn,14000000,13024170,13024170,26048340,12048340,0.8605957142857142,1994,5
5,1995-12-14,Othello,11000000,2844379,2844379,5688758,-5311242,-0.48284018181818184,1995,12
5,1996-03-08,Fargo,7000000,24567751,51204567,75772318,68772318,9.824616857142857,1996,3
5,1996-07-17,Multiplicity,45000000,20133326,20133326,40266652,-4733348,-0.10518551111111112,1996,7
5,1996-08-23,She's the One,3500000,9482579,13795053,23277632,19777632,5.650752,1996,8
5,1998-02-27,Dark City,27000000,14435076,27257061,41692137,14692137,0.5441532222222222,1998,2
5,1998-03-20,Primary Colors,65000000,39017984,39017984,78035968,13035968,0.20055335384615386,1998,3
5,1999-08-27,Stiff Upper Lips,5700000,69582,69582,139164,-5560836,-0.9755852631578947,1999,8
5,1999-12-24,The Talented Mr. Ripley,40000000,81292135,128792135,210084270,170084270,4.25210675,1999,12
5,2000-07-21,Pokemon 2000,30000000,43746923,133946923,177693846,147693846,4.9231282,2000,7
5,2000-11-10,Red Planet,80000000,17480890,33463969,50944859,-29055141,-0.3631892625,2000,11
5,2002-03-15,Y Tu MamÃ¡ TambiÃ©n,5000000,13649881,33649881,47299762,42299762,8.4599524,2002,3
5,2002-04-26,"Life, or Something Like It",40000000,14448589,14448589,28897178,-11102822,-0.27757055,2002,4
5,2002-08-16,The Adventures of Pluto Nash,100000000,4411102,7094995,11506097,-88493903,-0.88493903,2002,8
5,2002-11-22,Die Another Day,142000000,160942139,431942139,592884278,450884278,3.1752413943661972,2002,11
5,2003-04-25,People I Know,20000000,121972,5694213,5816185,-14183815,-0.70919075,2003,4
5,2004-04-30,Bobby Jones: Stroke of Genius,17000000,2694071,2694071,5388142,-11611858,-0.6830504705882353,2004,4
5,2004-07-09,Riding Giants,2600000,2276368,3292333,5568701,2968701,1.141808076923077,2004,7
5,2004-10-01,Woman Thou Art Loosed,3000000,6879730,6879730,13759460,10759460,3.5864866666666666,2004,10
5,2004-12-03,House of Flying Daggers,12000000,11050094,92863945,103914039,91914039,7.65950325,2004,12
5,2005-01-28,"Peace, Propaganda and the Promised Land",70000,4930,4930,9860,-60140,-0.8591428571428571,2005,1
5,2005-05-19,Star Wars Ep. III: Revenge of the Sith,115000000,380270577,848998877,1229269454,1114269454,9.6892996,2005,5
5,2005-10-21,Dreamer: Inspired by a True Story,32000000,33022286,39498360,72520646,40520646,1.2662701875,2005,10
5,2006-03-10,Failure to Launch,50000000,88715192,128402901,217118093,167118093,3.34236186,2006,3
5,2006-04-28,Moartea domnului Lazarescu,425000,80301,581304,661605,236605,0.5567176470588235,2006,4
5,2006-08-04,The Night Listener,4000000,7836393,10770993,18607386,14607386,3.6518465,2006,8
5,2007-02-23,Reno 911!: Miami,10000000,20342161,21851362,42193523,32193523,3.2193523,2007,2
5,2007-09-14,King of California,10000000,268461,1165102,1433563,-8566437,-0.8566437,2007,9
5,2008-01-18,All Hat,4900000,15198,15198,30396,-4869604,-0.9937967346938775,2008,1
5,2008-07-25,Man on Wire,1900000,2962242,5617067,8579309,6679309,3.5154257894736842,2008,7
5,2008-10-03,Blindness,25000000,3073392,20052958,23126350,-1873650,-0.074946,2008,10
5,2009-05-29,Pontypool,1500000,3865,31916,35781,-1464219,-0.976146,2009,5
5,2011-11-04,Tower Heist,85000000,78046570,150422946,228469516,143469516,1.6878766588235294,2011,11
5,2011-11-16,The Descendants,20000000,82624961,175507800,258132761,238132761,11.90663805,2011,11
5,2012-10-26,Silent Hill: Revelation 3D,20000000,17530219,55975672,73505891,53505891,2.67529455,2012,10
5,2015-01-16,Paddington,55000000,76223578,258789097,335012675,280012675,5.091139545454546,2015,1
5,2015-01-30,Wild Card,30000000,3200,4315789,4318989,-25681011,-0.8560337,2015,1
5,2015-10-02,Shanghai,50000000,46425,15505922,15552347,-34447653,-0.68895306,2015,10
5,2016-09-02,Morgan,8000000,3915251,7298786,11214037,3214037,0.401754625,2016,9
5,2017-04-07,Smurfs: The Lost Village,60000000,45020282,197578586,242598868,182598868,3.0433144666666667,2017,4
5,2017-06-16,Cars 3,175000000,152901115,383541369,536442484,361442484,2.0653856228571428,2017,6
5,2017-11-10,Daddyâs Home 2,70000000,104029443,175807183,279836626,209836626,2.9976660857142856,2017,11
5,2017-12-15,Star Wars Ep. VIII: The Last Jedi,317000000,620181382,1316721747,1936903129,1619903129,5.110104507886435,2017,12
5,2018-10-05,A Star is Born,36000000,215288866,433449571,648738437,612738437,17.02051213888889,2018,10
5,2018-12-25,Destroyer,9000000,1533324,3681096,5214420,-3785580,-0.42062,2018,12
6,1935-09-06,Top Hat,609000,1782000,3202000,4984000,4375000,7.183908045977011,1935,9
6,1980-01-01,Terror Train,3500000,8000000,8000000,16000000,12500000,3.5714285714285716,1980,1
6,1986-08-29,Shanghai Surprise,17000000,2315000,2315000,4630000,-12370000,-0.7276470588235294,1986,8
6,1987-05-15,Ishtar,40000000,14375181,14375181,28750362,-11249638,-0.28124095,1987,5
6,1995-02-03,The Jerky Boys,4000000,7555256,7555256,15110512,11110512,2.777628,1995,2
6,1995-05-12,The Perez Family,11000000,2794056,2794056,5588112,-5411888,-0.4919898181818182,1995,5
6,1995-11-03,Home for the Holidays,20000000,17468887,22119269,39588156,19588156,0.9794078,1995,11
6,1996-11-20,Sling Blade,4833610,24475416,34175000,58650416,53816806,11.133874267886736,1996,11
6,1997-10-24,Rien ne va plus,10000000,245359,5045359,5290718,-4709282,-0.4709282,1997,10
6,1998-07-15,There's Something About Mary,22000000,176484651,369884651,546369302,524369302,23.834968272727274,1998,7
6,1998-07-24,Jane Austen's Mafia,10000000,19843795,30143795,49987590,39987590,3.998759,1998,7
6,1999-10-15,Fight Club,65000000,37030102,100851705,137881807,72881807,1.1212585692307693,1999,10
6,1999-11-19,Sleepy Hollow,70000000,101068340,207068340,308136680,238136680,3.401952571428571,1999,11
6,2000-11-22,102 Dalmatians,85000000,66941559,66941559,133883118,48883118,0.5750955058823529,2000,11
6,2001-04-11,Kingdom Come,7000000,23247539,23393939,46641478,39641478,5.663068285714286,2001,4
6,2002-03-22,Sorority Boys,12000000,10198766,12516222,22714988,10714988,0.8929156666666667,2002,3
6,2002-05-16,Star Wars Ep. II: Attack of the Clones,115000000,310676740,656695615,967372355,852372355,7.4119335217391304,2002,5
6,2002-10-18,Real Women Have Curves,3000000,5853194,7777790,13630984,10630984,3.5436613333333336,2002,10
6,2003-07-09,Pirates of the Caribbean: The Curse of the Black Pearl,140000000,305411224,634954103,940365327,800365327,5.716895192857143,2003,7
6,2003-10-03,School of Rock,20000000,81261177,131944672,213205849,193205849,9.66029245,2003,10
6,2003-11-26,Les Triplettes de Belleville,2000000,7301288,17403168,24704456,22704456,11.352228,2003,11
6,2004-02-27,"Good Bye, Lenin!",6400000,4063859,79384539,83448398,77048398,12.0388121875,2004,2
6,2004-09-24,Shaun of the Dead,5000000,13542874,30332385,43875259,38875259,7.7750518,2004,9
6,2005-01-21,Gory Gory Hallelujah,425000,12604,12604,25208,-399792,-0.9406870588235294,2005,1
6,2005-09-23,A History of Violence,32000000,31493782,61477797,92971579,60971579,1.90536184375,2005,9
6,2006-03-24,Inside Man,50000000,88634237,185798265,274432502,224432502,4.48865004,2006,3
6,2006-04-28,R.V.,55000000,71724497,87473024,159197521,104197521,1.8945003818181818,2006,4
6,2006-08-18,Trust the Man,9000000,1530535,2548378,4078913,-4921087,-0.5467874444444445,2006,8
6,2006-10-13,Infamous,13000000,1151330,2613717,3765047,-9234953,-0.710381,2006,10
6,2007-01-12,Arthur et les Minimoys,80000000,15132763,113325743,128458506,48458506,0.605731325,2007,1
6,2007-03-16,I Think I Love My Wife,14000000,12559771,13205411,25765182,11765182,0.8403701428571428,2007,3
6,2008-09-19,The Duchess,27000000,13848978,45160110,59009088,32009088,1.1855217777777778,2008,9
6,2008-12-12,Los CronocrÃ­menes,2600000,39127,564474,603601,-1996399,-0.7678457692307692,2008,12
6,2009-08-07,G.I. Joe: The Rise of Cobra,175000000,150201498,302469017,452670515,277670515,1.5866886571428571,2009,8
6,2010-10-08,Nowhere Boy,1900000,1445366,7785229,9230595,7330595,3.858207894736842,2010,10
6,2010-11-05,127 Hours,18000000,18335230,60217171,78552401,60552401,3.364022277777778,2010,11
6,2011-02-11,Gnomeo and Juliet,36000000,99967670,193737977,293705647,257705647,7.158490194444444,2011,2
6,2012-01-20,Jin lÃ­ng shÃ­ san chai,100000000,311434,98227017,98538451,-1461549,-0.01461549,2012,1
6,2012-09-07,The Inbetweeners,5700000,35955,86051320,86087275,80387275,14.103030701754387,2012,9
6,2014-10-24,John Wick,30000000,43037835,76235001,119272836,89272836,2.9757612,2014,10
6,2014-11-28,The Imitation Game,15000000,91125143,227740463,318865606,303865606,20.257707066666665,2014,11
6,2015-06-05,United Passions,30000000,918,168832,169750,-29830250,-0.9943416666666667,2015,6
6,2015-09-25,The Intern,40000000,75764672,197115710,272880382,232880382,5.82200955,2015,9
6,2015-09-28,"Me, You and Five Bucks",1500000,2105,2105,4210,-1495790,-0.9971933333333334,2015,9
6,2015-10-30,Regression,20000000,55039,15824374,15879413,-4120587,-0.20602935,2015,10
6,2015-11-20,The Night Before,25000000,43035725,52427346,95463071,70463071,2.81852284,2015,11
6,2015-12-18,Star Wars Ep. VII: The Force Awakens,306000000,936662225,2053311220,-1304993851,-1610993851,-5.2646857875816995,2015,12
6,2015-12-30,Anomalisa,8000000,3759286,5706168,9465454,1465454,0.18318175,2015,12
6,2016-03-04,Whiskey Tango Foxtrot,35000000,23083334,25350747,48434081,13434081,0.3838308857142857,2016,3
6,2016-09-23,Queen of Katwe,15000000,8874389,10055481,18929870,3929870,0.26199133333333335,2016,9
6,2018-04-13,Sgt. Stubby: An American Hero,25000000,3054285,3645957,6700242,-18299758,-0.73199032,2018,4
6,2018-10-12,First Man,60000000,44936545,105203825,150140370,90140370,1.5023395,2018,10
6,2019-05-03,UglyDolls,45000000,19894664,24644664,44539328,-460672,-0.010237155555555556,2019,5
7,1925-11-19,The Big Parade,245000,11000000,22000000,33000000,32755000,133.69387755102042,1925,11
7,1970-01-01,The Molly Maguires,11000000,2200000,2200000,4400000,-6600000,-0.6,1970,1
7,1974-12-20,The Man with the Golden Gun,7000000,21000000,97600000,118600000,111600000,15.942857142857143,1974,12
7,1981-08-28,Gallipoli,3000000,5732587,5732587,11465174,8465174,2.821724666666667,1981,8
7,1988-03-30,Beetlejuice,15000000,73839613,73887546,147727159,132727159,8.848477266666666,1988,3
7,1992-02-28,Memoirs of an Invisible Man,40000000,14358033,14358033,28716066,-11283934,-0.28209835,1992,2
7,1992-09-25,The Last of the Mohicans,40000000,75505856,75505856,151011712,111011712,2.7752928,1992,9
7,1993-10-15,The Beverly Hillbillies,25000000,42222647,55598481,97821128,72821128,2.91284512,1993,10
7,1994-10-28,Stargate,55000000,71565669,196565669,268131338,213131338,3.8751152363636363,1994,10
7,1994-11-11,The Santa Clause,22000000,144833357,189800000,334633357,312633357,14.210607136363636,1994,11
7,1998-06-26,Smoke Signals,2000000,6719300,7756617,14475917,12475917,6.2379585,1998,6
7,1998-07-10,Pi,68000,3221152,4678513,7899665,7831665,115.17154411764706,1998,7
7,1998-08-14,La femme de chambre du Titanic,10000000,244465,244465,488930,-9511070,-0.951107,1998,8
7,1998-11-06,Gods and Monsters,3500000,6451628,6451628,12903256,9403256,2.6866445714285714,1998,11
7,1999-06-30,Wild Wild West,175000000,113805681,221229335,335035016,160035016,0.9144858057142857,1999,6
7,1999-07-14,The Blair Witch Project,600000,140539099,248300000,388839099,388239099,647.065165,1999,7
7,2000-03-24,Whatever it Takes,15000000,8735529,8735529,17471058,2471058,0.1647372,2000,3
7,2000-05-19,Small Time Crooks,18000000,17266359,29934477,47200836,29200836,1.6222686666666666,2000,5
7,2001-01-19,The Pledge,45000000,19719930,29406132,49126062,4126062,0.09169026666666667,2001,1
7,2001-11-02,"Monsters, Inc.",115000000,289423425,559757719,849181144,734181144,6.384183860869565,2001,11
7,2001-12-14,Vanilla Sky,70000000,100614858,202726605,303341463,233341463,3.3334494714285716,2001,12
7,2002-02-15,John Q,36000000,71026631,102226631,173253262,137253262,3.812590611111111,2002,2
7,2003-07-11,Northfork,1900000,1420578,1445140,2865718,965718,0.5082726315789474,2003,7
7,2004-04-09,Ella Enchanted,35000000,22913677,22913677,45827354,10827354,0.30935297142857143,2004,4
7,2005-08-26,Undiscovered,9000000,1069318,1069318,2138636,-6861364,-0.7623737777777778,2005,8
7,2005-12-23,CachÃ©,8000000,3647381,19891331,23538712,15538712,1.942339,2005,12
7,2006-01-06,Hostel,4800000,47326473,82241110,129567583,124767583,25.993246458333335,2006,1
7,2006-01-13,Glory Road,30000000,42647449,42799060,85446509,55446509,1.8482169666666666,2006,1
7,2007-04-13,Disturbia,20000000,80818974,118537627,199356601,179356601,8.96783005,2007,4
7,2007-08-17,The Invasion,80000000,15074191,40147042,55221233,-24778767,-0.3097345875,2007,8
7,2007-10-10,Control,6400000,871577,8902141,9773718,3373718,0.5271434375,2007,10
7,2007-12-28,El orfanato,4000000,7159147,79250193,86409340,82409340,20.602335,2007,12
7,2008-08-22,Death Race,65000000,36316032,72516819,108832851,43832851,0.6743515538461539,2008,8
7,2008-10-31,The Haunting of Molly Hartley,5000000,13442412,15318257,28760669,23760669,4.7521338,2008,10
7,2009-05-08,Star Trek,140000000,257730019,386839614,644569633,504569633,3.6040688071428573,2009,5
7,2009-06-19,Year One,60000000,43337279,57604723,100942002,40942002,0.6823667,2009,6
7,2010-07-16,Valhalla Rising,5700000,30638,731613,762251,-4937749,-0.8662717543859649,2010,7
7,2010-10-01,Case 39,27000000,13261851,28773827,42035678,15035678,0.556876962962963,2010,10
7,2010-12-25,L'illusionniste,17000000,2231474,8609949,10841423,-6158577,-0.36226923529411764,2010,12
7,2011-07-29,Attack the Block,13000000,1024175,6459183,7483358,-5516642,-0.42435707692307695,2011,7
7,2011-12-16,Carnage,25000000,2546747,38112154,40658901,15658901,0.62635604,2011,12
7,2012-03-30,Mirror Mirror,85000000,64935167,173613482,238548649,153548649,1.8064546941176471,2012,3
7,2013-03-15,The Incredible Burt Wonderstone,32000000,22537881,27392609,49930490,17930490,0.5603278125,2013,3
7,2014-04-25,Blue Ruin,420000,258384,437002,695386,275386,0.6556809523809524,2014,4
7,2015-02-20,Hot Tub Time Machine 2,14000000,12314651,12826644,25141295,11141295,0.7958067857142858,2015,2
7,2015-10-23,Paranormal Activity: The Ghost Dimension,10000000,18297124,77959374,96256498,86256498,8.6256498,2015,10
7,2015-11-06,The Peanuts Movie,99000000,130178411,250091610,380270021,281270021,2.8411113232323233,2015,11
7,2017-03-31,The Zookeeperâs Wife,20000000,17445186,26308749,43753935,23753935,1.18769675,2017,3
7,2017-07-28,The Emoji Movie,50000000,86089513,216562312,302651825,252651825,5.0530365,2017,7
7,2017-10-13,Marshall,12000000,10051659,10116816,20168475,8168475,0.68070625,2017,10
7,2018-04-27,Avengers: Infinity War,300000000,678815482,2048134200,-1568017614,-1868017614,-6.22672538,2018,4
8,1959-11-18,Ben-Hur,15000000,73000000,73259017,146259017,131259017,8.750601133333333,1959,11
8,1970-03-26,Woodstock,600000,34505110,34505110,69010220,68410220,114.01703333333333,1970,3
8,1981-01-01,Roar,17000000,2110050,2110050,4220100,-12779900,-0.7517588235294118,1981,1
8,1988-02-12,Action Jackson,7000000,20257000,20257000,40514000,33514000,4.787714285714285,1988,2
8,1991-01-01,Return to the Blue Lagoon,11000000,2000000,2000000,4000000,-7000000,-0.6363636363636364,1991,1
8,1993-07-16,Free Willy,20000000,77698625,153698625,231397250,211397250,10.5698625,1993,7
8,1994-02-25,Sugar Hill,10000000,18272447,18423914,36696361,26696361,2.6696361,1994,2
8,1995-02-10,The Quick and the Dead,32000000,18552460,18552460,37104920,5104920,0.15952875,1995,2
8,1996-10-11,The Long Kiss Goodnight,65000000,33447612,33447612,66895224,1895224,0.029157292307692307,1996,10
8,1997-06-13,Hercules,70000000,99112101,250700000,349812101,279812101,3.9973157285714285,1997,6
8,1998-02-20,I Love You â¦ Don't Touch Me!,68000,33598,33598,67196,-804,-0.011823529411764707,1998,2
8,1998-07-01,Armageddon,140000000,201578182,554600000,756178182,616178182,4.401272728571429,1998,7
8,1998-11-06,Velvet Goldmine,9000000,1053788,4313644,5367432,-3632568,-0.4036186666666667,1998,11
8,1999-09-17,Blue Streak,36000000,68208190,117448157,185656347,149656347,4.15712075,1999,9
8,2000-05-12,Center Stage,18000000,17200925,21361109,38562034,20562034,1.1423352222222223,2000,5
8,2002-12-27,The Hours,25000000,41675994,97030468,138706462,113706462,4.54825848,2002,12
8,2003-03-12,Bend it Like Beckham,5600000,32543449,74566042,107109491,101509491,18.126694821428572,2003,3
8,2003-03-21,Boat Trip,15000000,8586376,14933713,23520089,8520089,0.5680059333333334,2003,3
8,2003-10-10,Kill Bill: Volume 1,55000000,70098138,176469428,246567566,191567566,3.4830466545454546,2003,10
8,2004-06-11,Napoleon Dynamite,400000,44540956,46122713,90663669,90263669,225.6591725,2004,6
8,2004-10-29,Ray,40000000,75305995,124823094,200129089,160129089,4.003227225,2004,10
8,2004-12-17,Imaginary Heroes,10000000,228524,290875,519399,-9480601,-0.9480601,2004,12
8,2005-06-10,The Honeymooners,27000000,12834849,13174426,26009275,-990725,-0.03669351851851852,2005,6
8,2005-09-02,A Sound of Thunder,80000000,1900451,6300451,8200902,-71799098,-0.897488725,2005,9
8,2005-12-16,The Producers: The Movie Musical,45000000,19398532,32952995,52351527,7351527,0.16336726666666668,2005,12
8,2006-04-28,Water,3000000,5529144,11322573,16851717,13851717,4.617239,2006,4
8,2006-11-17,Bobby,14000000,11242801,20597806,31840607,17840607,1.2743290714285713,2006,11
8,2006-12-08,The Holiday,85000000,63280000,205190324,268470324,183470324,2.1584744,2006,12
8,2007-05-24,Pirates of the Caribbean: At Worldâs End,300000000,309420425,963420425,1272840850,972840850,3.242802833333333,2007,5
8,2007-05-25,Bug,4000000,7006708,8302995,15309703,11309703,2.82742575,2007,5
8,2007-09-28,The Game Plan,22000000,90648202,146590987,237239189,215239189,9.7835995,2007,9
8,2008-08-01,The Mummy: Tomb of the Dragon Emperor,175000000,102491776,405760225,508252001,333252001,1.9042971485714286,2008,8
8,2008-10-31,Little Big Top,240000,7484,7484,14968,-225032,-0.9376333333333333,2008,10
8,2008-12-05,Cadillac Records,12000000,8195551,8942516,17138067,5138067,0.42817225,2008,12
8,2009-02-20,Fired Up,20000000,17231291,18608570,35839861,15839861,0.79199305,2009,2
8,2009-10-09,The Damned United,6400000,449865,4199874,4649739,-1750261,-0.27347828125,2009,10
8,2009-10-23,Amelia,40000000,14279575,19756077,34035652,-5964348,-0.1491087,2009,10
8,2010-01-29,Edge of Darkness,60000000,43313890,82812456,126126346,66126346,1.1021057666666667,2010,1
8,2010-04-16,El secreto de sus ojos,3500000,6391436,40527719,46919155,43419155,12.405472857142858,2010,4
8,2010-06-11,Winter's Bone,2000000,6531503,16131551,22663054,20663054,10.331527,2010,6
8,2010-12-29,Another Year,8000000,3205706,20005613,23211319,15211319,1.901414875,2010,12
8,2011-07-29,"Crazy, Stupid, Love",50000000,84351197,147142328,231493525,181493525,3.6298705,2011,7
8,2013-07-19,Only God Forgives,4800000,775849,4494560,5270409,470409,0.098001875,2013,7
8,2013-07-26,The Wolverine,115000000,132556852,416456852,549013704,434013704,3.7740322086956524,2013,7
8,2015-04-24,Brotherly Love,1900000,478595,478595,957190,-942810,-0.4962157894736842,2015,4
8,2015-04-24,The Age of Adaline,30000000,42629776,68984536,111614312,81614312,2.7204770666666667,2015,4
8,2015-08-14,Brothers,13000000,656688,17856688,18513376,5513376,0.42410584615384617,2015,8
8,2015-08-21,Hitman: Agent 47,35000000,22467450,82182803,104650253,69650253,1.9900072285714285,2015,8
8,2016-07-15,Hillaryâs America: The Secret History of the Democratic Party,5000000,13099931,13099931,26199862,21199862,4.2399724,2016,7
8,2017-09-01,Tulip Fever,25000000,2455635,6792768,9248403,-15751597,-0.63006388,2017,9
8,2019-02-08,The LEGO Movie 2: The Second Part,99000000,105806508,190325698,296132206,197132206,1.991234404040404,2019,2
9,1975-05-10,Monty Python and the Holy Grail,400000,3427696,5028948,8456644,8056644,20.14161,1975,5
9,1977-08-10,The Kentucky Fried Movie,600000,15000000,20000000,35000000,34400000,57.333333333333336,1977,8
9,1983-05-13,Breathless,7000000,19910002,19910002,39820004,32820004,4.688572,1983,5
9,1983-10-07,Never Say Never Again,36000000,55500000,160000000,215500000,179500000,4.986111111111111,1983,10
9,1985-06-21,Return to Oz,27000000,10618813,10618813,21237626,-5762374,-0.21342125925925926,1985,6
9,1987-03-13,Evil Dead II,3500000,5923044,5926177,11849221,8349221,2.385491714285714,1987,3
9,1994-06-15,The Lion King,79300000,421785283,986214868,1408000151,1328700151,16.75536129886507,1994,6
9,1996-06-07,The Phantom,45000000,17220599,17220599,34441198,-10558802,-0.23464004444444445,1996,6
9,1996-06-21,Lone Star,5000000,12961389,12961389,25922778,20922778,4.1845556,1996,6
9,1997-02-07,Dante's Peak,115000000,67163857,178200000,245363857,130363857,1.1335987565217391,1997,2
9,1997-08-22,Money Talks,25000000,41076865,41076865,82153730,57153730,2.2861492,1997,8
9,1999-02-26,20 Dates,66000,541636,602920,1144556,1078556,16.341757575757576,1999,2
9,2000-12-08,Proof of Life,65000000,32598931,62761005,95359936,30359936,0.46707593846153844,2000,12
9,2000-12-29,The Claim,13000000,622023,1375635,1997658,-11002342,-0.846334,2000,12
9,2001-02-02,Head Over Heels,14000000,10397365,10397365,20794730,6794730,0.48533785714285715,2001,2
9,2001-10-26,High Heels and Low Lifes,10000000,226792,226792,453584,-9546416,-0.9546416,2001,10
9,2002-03-29,The Rookie,22000000,75600072,80491516,156091588,134091588,6.095072181818182,2002,3
9,2002-05-22,The Importance of Being Earnest,15000000,8378141,8378141,16756282,1756282,0.11708546666666667,2002,5
9,2002-07-03,Men in Black 2,140000000,190418803,441767803,632186606,492186606,3.515618614285714,2002,7
9,2002-09-20,8 femmes,8000000,3076425,42376425,45452850,37452850,4.68160625,2002,9
9,2002-10-11,The Rules of Attraction,4000000,6525762,11799060,18324822,14324822,3.5812055,2002,10
9,2002-12-13,Star Trek: Nemesis,60000000,43254409,67312826,110567235,50567235,0.84278725,2002,12
9,2003-10-17,Veronica Guerin,17000000,1569918,9438074,11007992,-5992008,-0.3524710588235294,2003,10
9,2004-04-30,Laws of Attraction,32000000,17848322,29948322,47796644,15796644,0.493645125,2004,4
9,2005-04-01,Sin City,40000000,74103820,158527918,232631738,192631738,4.81579345,2005,4
9,2005-04-08,Kung Fu Hustle,20000000,17104669,102034104,119138773,99138773,4.95693865,2005,4
9,2006-01-06,BloodRayne,25000000,2405420,3711633,6117053,-18882947,-0.75531788,2006,1
9,2006-06-16,The Fast and the Furious: Tokyo Drift,85000000,62615510,157794205,220409715,135409715,1.5930554705882354,2006,6
9,2006-09-01,Crossover,5600000,7009668,7009668,14019336,8419336,1.5034528571428571,2006,9
9,2007-06-22,Evan Almighty,175000000,100289690,174131329,274421019,99421019,0.5681201085714286,2007,6
9,2007-09-07,Romance and Cigarettes,11000000,551002,3231251,3782253,-7217747,-0.6561588181818182,2007,9
9,2008-02-22,Die FÃ¤lscher,6250000,5488570,20199663,25688233,19438233,3.11011728,2008,2
9,2008-06-20,Kit Kittredge: An American Girl,10000000,17657973,17657973,35315946,25315946,2.5315946,2008,6
9,2008-07-25,The X-Files: I Want to Believe,35000000,20982478,68170792,89153270,54153270,1.5472362857142856,2008,7
9,2009-10-09,Bronson,230000,104979,2703762,2808741,2578741,11.211917391304349,2009,10
9,2009-10-23,Cirque du Freak: The Vampire's Assistant,40000000,14046595,39753957,53800552,13800552,0.3450138,2009,10
9,2009-12-11,Rocket Singh: Salesman of the Year,1070000,164649,5348767,5513416,4443416,4.15272523364486,2009,12
9,2010-05-14,Princess Kaiulani,9000000,883887,883887,1767774,-7232226,-0.8035806666666667,2010,5
9,2010-08-06,Step Up 3D,30000000,42400223,165889117,208289340,178289340,5.942978,2010,8
9,2011-06-03,Submarine,1900000,467602,4581937,5049539,3149539,1.6576521052631579,2011,6
9,2011-06-17,Mr. Poppers's Penguins,55000000,68224452,189624452,257848904,202848904,3.688161890909091,2011,6
9,2011-09-30,Take Shelter,4750000,1728953,4972016,6700969,1950969,0.41073031578947367,2011,9
9,2012-09-14,Arbitrage,12000000,7919574,35830713,43750287,31750287,2.64585725,2012,9
9,2013-01-18,Mama,15000000,71628180,148095566,219723746,204723746,13.648249733333333,2013,1
9,2013-03-22,Olympus Has Fallen,70000000,98927592,172878928,271806520,201806520,2.8829502857142857,2013,3
9,2014-10-10,Meet the Mormons,2000000,6047363,6049171,12096534,10096534,5.048267,2014,10
9,2016-01-15,Norm of the North,18000000,17062499,30535660,47598159,29598159,1.6443421666666667,2016,1
9,2016-07-22,Donât Think Twice,3000000,4417983,4417983,8835966,5835966,1.945322,2016,7
9,2016-10-21,Tyler Perryâs Boo! A Madea Halloween,20000000,73206343,73206343,146412686,126412686,6.3206343,2016,10
9,2017-11-17,Justice League,300000000,229024295,655945209,884969504,584969504,1.9498983466666666,2017,11
9,2017-12-22,The Post,50000000,81903458,179748880,261652338,211652338,4.23304676,2017,12
9,2018-11-21,Robin Hood,99000000,30824628,84747441,115572069,16572069,0.16739463636363636,2018,11
10,1943-01-23,Casablanca,1039000,10462500,10496855,20959355,19920355,19.17262271414822,1943,1
10,1960-10-24,The Alamo,12000000,7900000,7900000,15800000,3800000,0.31666666666666665,1960,10
10,1967-05-10,Per qualche dollaro in piÃ¹,600000,4300000,4300000,8600000,8000000,13.333333333333334,1967,5
10,1969-12-19,Topaz,4000000,6000000,6000000,12000000,8000000,2.0,1969,12
10,1980-10-10,Private Benjamin,15000000,69847348,69847348,139694696,124694696,8.312979733333334,1980,10
10,1985-06-30,Day of the Dead,3500000,5804262,34004262,39808524,36308524,10.373864,1985,6
10,1985-09-27,Invasion U.S.A.,10000000,17536256,17536256,35072512,25072512,2.5072512,1985,9
10,1986-03-27,April Fool's Day,5000000,12947763,12947763,25895526,20895526,4.1791052,1986,3
10,1988-01-15,Return of the Living Dead Part II,6200000,9205924,9205924,18411848,12211848,1.9696529032258066,1988,1
10,1991-01-01,Showdown in Little Tokyo,8000000,2275557,2275557,4551114,-3448886,-0.43111075,1991,1
10,1995-06-02,The Bridges of Madison County,22000000,71516617,175516617,247033234,225033234,10.228783363636364,1995,6
10,1995-07-28,Waterworld,175000000,88246220,264246220,352492440,177492440,1.0142425142857143,1995,7
10,1995-08-18,Mortal Kombat,20000000,70433227,122133227,192566454,172566454,8.6283227,1995,8
10,1998-03-27,The Newton Boys,27000000,10341093,10341093,20682186,-6317814,-0.23399311111111112,1998,3
10,1999-02-05,Payback,50000000,81526121,161626121,243152242,193152242,3.86304484,1999,2
10,1999-05-21,The Love Letter,15000000,8322608,9010980,17333588,2333588,0.15557253333333335,1999,5
10,1999-08-13,Bowfinger,55000000,66458769,98699769,165158538,110158538,2.002882509090909,1999,8
10,2000-05-05,Michael Jordan to the MAX,7000000,18642318,18642318,37284636,30284636,4.326376571428572,2000,5
10,2001-05-04,The Mummy Returns,98000000,202007640,435040395,637048035,539048035,5.500490153061224,2001,5
10,2001-11-02,The One,49000000,43905746,72689126,116594872,67594872,1.3794871836734695,2001,11
10,2002-02-19,Reign of Fire,60000000,43061982,82150183,125212165,65212165,1.0868694166666666,2002,2
10,2002-06-21,Sunshine State,5600000,3064356,3281898,6346254,746254,0.13325964285714287,2002,6
10,2002-07-26,The Country Bears,20000000,16988996,16988996,33977992,13977992,0.6988996,2002,7
10,2003-06-20,The Legend of Suriyothai,9000000,454255,454255,908510,-8091490,-0.8990544444444445,2003,6
10,2003-08-15,American Splendor,2000000,6003587,8685632,14689219,12689219,6.3446095,2003,8
10,2004-02-06,Catch That Kid,18000000,16703799,16959614,33663413,15663413,0.8701896111111111,2004,2
10,2004-05-07,Super Size Me,65000,11529368,22233808,33763176,33698176,518.4334769230769,2004,5
10,2004-05-07,New York Minute,40000000,14018364,21215882,35234246,-4765754,-0.11914385,2004,5
10,2005-07-01,Rebound,45000000,16809014,17492014,34301028,-10698972,-0.23775493333333333,2005,7
10,2005-11-11,Zathura,65000000,28045540,58545540,86591080,21591080,0.3321704615384615,2005,11
10,2005-12-09,Memoirs of a Geisha,85000000,57010853,161510853,218521706,133521706,1.5708436,2005,12
10,2006-01-27,Tristram Shandy: A Cock and Bull Story,4750000,1253413,3061763,4315176,-434824,-0.0915418947368421,2006,1
10,2006-08-02,Quinceanera,400000,1692693,2797199,4489892,4089892,10.22473,2006,8
10,2006-11-10,Copying Beethoven,11000000,355968,6586324,6942292,-4057708,-0.36888254545454546,2006,11
10,2007-12-26,There Will Be Blood,25000000,40222514,77208711,117431225,92431225,3.697249,2007,12
10,2009-05-29,Drag Me To Hell,30000000,42100625,91388487,133489112,103489112,3.4496370666666665,2009,5
10,2009-08-21,World's Greatest Dad,10000000,221805,295750,517555,-9482445,-0.9482445,2009,8
10,2010-03-26,Hot Tub Time Machine,36000000,50269859,65967750,116237609,80237609,2.2288224722222223,2010,3
10,2010-04-09,The Square,1900000,406216,740932,1147148,-752852,-0.3962378947368421,2010,4
10,2011-03-11,Battle: Los Angeles,70000000,83552429,213463976,297016405,227016405,3.2430915,2011,3
10,2011-07-22,Captain America: The First Avenger,140000000,176654505,370569776,547224281,407224281,2.908744864285714,2011,7
10,2011-12-23,In The Land of Blood and Honey,13000000,303877,509193,813070,-12186930,-0.9374561538461539,2011,12
10,2012-02-10,Journey 2: The Mysterious Island,79000000,103860290,318146162,422006452,343006452,4.3418538227848105,2012,2
10,2012-07-20,Burn,225000,1109276,1109276,2218552,1993552,8.86023111111111,2012,7
10,2012-08-24,Premium Rush,35000000,20275446,31393201,51668647,16668647,0.47624705714285714,2012,8
10,2012-10-26,Fun Size,14000000,9409538,11166615,20576153,6576153,0.4697252142857143,2012,10
10,2015-10-16,Bridge of Spies,40000000,72313754,162498338,234812092,194812092,4.8703023,2015,10
10,2015-11-06,Spectre,300000000,200074175,879620923,1079695098,779695098,2.59898366,2015,11
10,2015-11-20,Legend,25000000,1872994,42425450,44298444,19298444,0.77193776,2015,11
10,2016-04-22,The Huntsman: Winterâs War,115000000,48003015,165149302,213152317,98152317,0.8534984086956522,2016,4
10,2016-06-10,Genius,17000000,1361045,7265283,8626328,-8373672,-0.4925689411764706,2016,6
10,2016-06-24,Swiss Army Man,3000000,4210454,5837111,10047565,7047565,2.349188333333333,2016,6
10,2018-10-12,Bad Times at the El Royale,32000000,17839115,29204379,47043494,15043494,0.4701091875,2018,10
11,1952-04-10,Singin' in the Rain,2540000,7200000,7200000,14400000,11860000,4.669291338582677,1952,4
11,1976-11-21,Rocky,1000000,117235147,225000000,342235147,341235147,341.235147,1976,11
11,1980-03-07,Coal Miner's Daughter,15000000,67182787,67182787,134365574,119365574,7.957704933333333,1980,3
11,1982-04-02,Diner,5000000,12592907,12592907,25185814,20185814,4.0371628,1982,4
11,1986-08-22,The Texas Chainsaw Massacre 2,4700000,8025872,8025872,16051744,11351744,2.415264680851064,1986,8
11,1991-10-25,Due occhi diabolici,9000000,349618,349618,699236,-8300764,-0.9223071111111111,1991,10
11,1995-06-09,Congo,50000000,81022333,152022333,233044666,183044666,3.66089332,1995,6
11,1997-05-02,Breakdown,36000000,50159144,50159144,100318288,64318288,1.7866191111111112,1997,5
11,1998-09-25,Clay Pigeons,8000000,1793359,2256606,4049965,-3950035,-0.493754375,1998,9
11,1999-03-12,The Deep End of the Ocean,40000000,13508635,13508635,27017270,-12982730,-0.32456825,1999,3
11,1999-04-23,Lost and Found,14000000,6552255,6552255,13104510,-895490,-0.06396357142857143,1999,4
11,2000-04-14,East is East,3000000,4170647,30438635,34609282,31609282,10.536427333333334,2000,4
11,2000-05-12,Screwed,12000000,6982680,6982680,13965360,1965360,0.16378,2000,5
11,2000-09-15,Urbania,225000,1032075,1032075,2064150,1839150,8.174,2000,9
11,2000-10-31,Mercy Streets,600000,173599,173599,347198,-252802,-0.4213366666666667,2000,10
11,2001-03-16,Enemy at the Gates,85000000,51396781,96971293,148368074,63368074,0.7455067529411765,2001,3
11,2002-04-26,Dogtown and Z-Boys,400000,1293295,1600566,2893861,2493861,6.2346525,2002,4
11,2002-06-14,Windtalkers,115000000,40914068,77628265,118542333,3542333,0.030802895652173912,2002,6
11,2002-12-20,The Wild Thornberrys Movie,25000000,40108697,60694737,100803434,75803434,3.03213736,2002,12
11,2002-12-20,Gangs of New York,97000000,77730500,183124621,260855121,163855121,1.6892280515463918,2002,12
11,2003-11-26,The Missing,65000000,26900336,38253433,65153769,153769,0.002365676923076923,2003,11
11,2004-04-16,Kill Bill: Volume 2,55000000,66207920,153535982,219743902,164743902,2.9953436727272726,2004,4
11,2004-06-23,White Chicks,20000000,69148997,111448997,180597994,160597994,8.0298997,2004,6
11,2004-08-13,AVP: Alien Vs. Predator,70000000,80281096,172543519,252824615,182824615,2.6117802142857145,2004,8
11,2004-08-27,Suspect Zero,27000000,8712564,8712564,17425128,-9574872,-0.3546248888888889,2004,8
11,2005-09-23,Roll Bounce,10000000,17380866,17433072,34813938,24813938,2.4813938,2005,9
11,2006-05-05,Hoot,15000000,8117637,8224998,16342635,1342635,0.089509,2006,5
11,2006-11-17,Let's Go to Prison,4000000,4630045,4630045,9260090,5260090,1.3150225,2006,11
11,2007-11-14,Southland Tales,17000000,275380,364607,639987,-16360013,-0.9623537058823529,2007,11
11,2008-02-22,Vantage Point,40000000,72266306,150886329,223152635,183152635,4.578815875,2008,2
11,2009-02-13,Gomorra,6200000,1579146,37339594,38918740,32718740,5.277216129032258,2009,2
11,2009-11-20,Bad Lieutenant: Port of Call New Orleans,25000000,1702112,12413949,14116061,-10883939,-0.43535756,2009,11
11,2009-11-20,Planet 51,60000000,42194060,108996113,151190173,91190173,1.5198362166666666,2009,11
11,2010-02-19,The Ghost Writer,45000000,15541549,65532491,81074040,36074040,0.8016453333333333,2010,2
11,2010-06-18,The Killer Inside Me,13000000,217277,3617277,3834554,-9165446,-0.7050343076923077,2010,6
11,2010-07-16,Standing Ovation,5600000,531806,531806,1063612,-4536388,-0.8100692857142857,2010,7
11,2010-09-03,Going the Distance,32000000,17804299,43603990,61408289,29408289,0.91900903125,2010,9
11,2011-08-26,Brighton Rock,11000000,229653,229653,459306,-10540694,-0.9582449090909091,2011,8
11,2011-11-11,Jack and Jill,79000000,74158157,150519217,224677374,145677374,1.8440173924050633,2011,11
11,2012-04-13,The Cabin in the Woods,30000000,42073277,70689968,112763245,82763245,2.7587748333333333,2012,4
11,2012-07-20,The Dark Knight Rises,275000000,448139099,1084439099,1532578198,1257578198,4.573011629090909,2012,7
11,2013-01-18,Broken City,35000000,19701164,34480045,54181209,19181209,0.5480345428571428,2013,1
11,2013-01-25,Supporting Characters,60000,4917,4917,9834,-50166,-0.8361,2013,1
11,2013-02-08,ABCD (Any Body Can Dance),1900000,222098,10137234,10359332,8459332,4.45228,2013,2
11,2013-05-03,"Cinco de Mayo, La Batalla",10000000,173472,173472,346944,-9653056,-0.9653056,2013,5
11,2013-08-16,Jobs,18000000,16131410,43402515,59533925,41533925,2.307440277777778,2013,8
11,2014-02-28,Son of God,22000000,59700064,70949793,130649857,108649857,4.938629863636364,2014,2
11,2015-03-06,Chappie,49000000,31569268,105002056,136571324,87571324,1.7871698775510203,2015,3
11,2015-06-19,Dope,7000000,17506470,18190831,35697301,28697301,4.099614428571429,2015,6
11,2016-01-29,Kung Fu Panda 3,140000000,143528619,517599142,661127761,521127761,3.72234115,2016,1
11,2017-05-12,King Arthur: Legend of the Sword,175000000,39175066,139630336,178805402,3805402,0.021745154285714285,2017,5
11,2017-09-29,Flatliners,20000000,16883115,45173738,62056853,42056853,2.10284265,2017,9
11,2017-10-06,The Florida Project,2000000,5904366,11295324,17199690,15199690,7.599845,2017,10
11,2018-05-18,First Reformed,3500000,3448256,3874772,7323028,3823028,1.0922937142857143,2018,5
12,1953-06-13,"The Beast from 20,000 Fathoms",210000,5000000,5000000,10000000,9790000,46.61904761904762,1953,6
12,1987-03-06,Lethal Weapon,15000000,65192350,120192350,185384700,170384700,11.35898,1987,3
12,1988-04-22,Lady in White,4700000,1705139,1705139,3410278,-1289722,-0.2744089361702128,1988,4
12,1989-12-22,Tango & Cash,55000000,63408614,63408614,126817228,71817228,1.3057677818181819,1989,12
12,1990-07-11,The Adventures of Ford Fairlane,49000000,20423389,20423389,40846778,-8153222,-0.16639228571428571,1990,7
12,1993-06-18,Last Action Hero,85000000,50016394,137298489,187314883,102314883,1.203704505882353,1993,6
12,1995-10-20,Mallrats,6100000,2108367,2108367,4216734,-1883266,-0.308732131147541,1995,10
12,1995-12-25,Four Rooms,4000000,4301000,4301000,8602000,4602000,1.1505,1995,12
12,1998-07-10,Lethal Weapon 4,140000000,130444603,285400000,415844603,275844603,1.970318592857143,1998,7
12,1998-12-11,Rushmore,10000000,17105219,19080435,36185654,26185654,2.6185654,1998,12
12,1999-10-22,Bringing Out The Dead,32000000,16640210,16640210,33280420,1280420,0.040013125,1999,10
12,2000-09-01,Whipped,3000000,4142507,4142507,8285014,5285014,1.7616713333333334,2000,9
12,2000-12-22,All the Pretty Horses,45000000,15527125,18120267,33647392,-11352608,-0.2522801777777778,2000,12
12,2001-06-01,The Animal,22000000,55762229,55762229,111524458,89524458,4.069293545454546,2001,6
12,2001-06-29,Pootie Tang,3500000,3293258,3293258,6586516,3086516,0.8818617142857142,2001,6
12,2001-10-26,Life as a House,18000000,15652637,23889158,39541795,21541795,1.1967663888888889,2001,10
12,2001-12-21,A Beautiful Mind,78000000,170708996,317668058,488377054,410377054,5.261244282051282,2001,12
12,2003-06-13,Rugrats Go Wild,25000000,39402572,55443032,94845604,69845604,2.79382416,2003,6
12,2003-09-19,Secondhand Lions,30000000,42070939,47902566,89973505,59973505,1.9991168333333333,2003,9
12,2004-11-05,Alfie,40000000,13395939,35195939,48591878,8591878,0.21479695,2004,11
12,2005-01-14,Elektra,65000000,24409722,56824633,81234355,16234355,0.2497593076923077,2005,1
12,2005-07-22,The Devil's Rejects,7000000,17044981,20940428,37985409,30985409,4.426487,2005,7
12,2005-08-19,Valiant,35000000,19478106,64188387,83666493,48666493,1.3904712285714285,2005,8
12,2006-10-20,Running With Scissors,12000000,6860000,8706701,15566701,3566701,0.2972250833333333,2006,10
12,2007-03-16,Dead Silence,20000000,16574590,20614661,37189251,17189251,0.85946255,2007,3
12,2007-06-29,Chacun sa nuit,1900000,18435,139317,157752,-1742248,-0.9169726315789474,2007,6
12,2007-11-02,Martian Child,27000000,7500310,9352089,16852399,-10147601,-0.3758370740740741,2007,11
12,2007-11-30,Le Scaphandre et le Papillon,14000000,5990075,22754472,28744547,14744547,1.0531819285714286,2007,11
12,2008-02-08,In Bruges,15000000,7800825,34533783,42334608,27334608,1.8223072,2008,2
12,2008-07-04,AstÃ©rix aux Jeux Olympiques,113500000,999811,132999811,133999622,20499622,0.18061340969162995,2008,7
12,2008-10-24,Heroes,400000,655538,655538,1311076,911076,2.27769,2008,10
12,2009-03-20,"I Love You, Man",40000000,72013010,92302502,164315512,124315512,3.1078878,2009,3
12,2009-03-20,Knowing,50000000,79957634,186450317,266407951,216407951,4.32815902,2009,3
12,2009-03-20,Duplicity,60000000,40572825,81079566,121652391,61652391,1.02753985,2009,3
12,2009-04-24,Obsessed,20000000,68261644,73964713,142226357,122226357,6.11131785,2009,4
12,2010-10-29,Welcome to the Rileys,10000000,152857,355919,508776,-9491224,-0.9491224,2010,10
12,2011-12-25,War Horse,70000000,79883359,156815529,236698888,166698888,2.381412685714286,2011,12
12,2012-01-06,The Devil Inside,1000000,53262945,101759490,155022435,154022435,154.022435,2012,1
12,2012-11-16,Le prÃ©nom,11000000,61611,25307405,25369016,14369016,1.3062741818181818,2012,11
12,2012-12-07,Khiladi 786,5600000,385422,14683763,15069185,9469185,1.690925892857143,2012,12
12,2013-01-11,A Haunted House,2500000,40041683,59922558,99964241,97464241,38.9856964,2013,1
12,2013-12-20,Le passÃ©,8000000,1335672,15752575,17088247,9088247,1.136030875,2013,12
12,2013-12-25,47 Ronin,175000000,38362475,151716815,190079290,15079290,0.08616737142857143,2013,12
12,2014-05-02,Water & Power,600000,42557,42557,85114,-514886,-0.8581433333333334,2014,5
12,2014-09-12,Dolphin Tale 2,36000000,42024533,57824533,99849066,63849066,1.7735851666666667,2014,9
12,2015-06-26,Escobar: Paradise Lost,17000000,195792,3917679,4113471,-12886529,-0.7580311176470588,2015,6
12,2016-01-29,Jane Got a Gun,25000000,1513793,3771345,5285138,-19714862,-0.78859448,2016,1
12,2016-05-06,Dheepan,9000000,248795,7704357,7953152,-1046848,-0.11631644444444444,2016,5
12,2017-03-03,Before I Fall,5000000,12241072,18945682,31186754,26186754,5.2373508,2017,3
12,2017-05-19,Alien: Covenant,97000000,74262031,238521247,312783278,215783278,2.2245698762886597,2017,5
12,2017-08-25,All Saints,2000000,5802208,5941994,11744202,9744202,4.872101,2017,8
12,2018-05-25,Solo: A Star Wars Story,275000000,213767512,393151347,606918859,331918859,1.206977669090909,2018,5
13,1963-10-07,Tom Jones,1000000,37600000,37600000,75200000,74200000,74.2,1963,10
13,1969-07-25,The Stewardesses,200000,13500000,25000000,38500000,38300000,191.5,1969,7
13,1978-06-16,Grease,6000000,181813770,387510179,569323949,563323949,93.88732483333334,1978,6
13,1983-04-15,Lone Wolf McQuade,5000000,12232628,12232628,24465256,19465256,3.8930512,1983,4
13,1990-01-19,Tremors,10000000,16667084,16667084,33334168,23334168,2.3334168,1990,1
13,1992-07-31,Death Becomes Her,55000000,58422650,149022650,207445300,152445300,2.7717327272727275,1992,7
13,1993-09-03,Fortress,12000000,6730578,46730578,53461156,41461156,3.4550963333333335,1993,9
13,1997-02-28,Kama Sutra,3000000,4109095,4109095,8218190,5218190,1.7393966666666667,1997,2
13,2000-02-23,Wonder Boys,35000000,19389454,33422485,52811939,17811939,0.5089125428571428,2000,2
13,2001-11-09,Shallow Hal,40000000,70836296,70836296,141672592,101672592,2.5418148,2001,11
13,2002-03-01,We Were Soldiers,70000000,78120196,114658262,192778458,122778458,1.7539779714285715,2002,3
13,2002-08-30,FearDotCom,40000000,13208023,13208023,26416046,-13583954,-0.33959885,2002,8
13,2002-09-20,Secretary,4000000,4046737,9413956,13460693,9460693,2.36517325,2002,9
13,2002-10-18,Formula 51,27000000,5204007,5204007,10408014,-16591986,-0.614518,2002,10
13,2003-04-18,Holes,20000000,67383924,71232214,138616138,118616138,5.9308069,2003,4
13,2003-09-26,The Rundown,85000000,47641743,80831893,128473636,43473636,0.5114545411764706,2003,9
13,2003-11-21,21 Grams,20000000,16248701,59667625,75916326,55916326,2.7958163,2003,11
13,2004-07-02,Before Sunset,2000000,5792822,11217346,17010168,15010168,7.505084,2004,7
13,2004-10-06,Tarnation,400000,592014,1162014,1754028,1354028,3.38507,2004,10
13,2005-03-18,The Ring Two,50000000,75941727,161941727,237883454,187883454,3.75766908,2005,3
13,2005-06-01,The Sisterhood of the Traveling Pants,25000000,39053061,41560117,80613178,55613178,2.22452712,2005,6
13,2006-10-06,Little Children,14000000,5463019,14121177,19584196,5584196,0.39887114285714287,2006,10
13,2006-10-13,Driving Lessons,4700000,239962,239962,479924,-4220076,-0.8978885106382979,2006,10
13,2006-11-10,Stranger Than Fiction,30000000,40435190,53572822,94008012,64008012,2.1336004,2006,11
13,2007-10-19,Arnolds Park,600000,23616,23616,47232,-552768,-0.92128,2007,10
13,2008-09-05,Bangkok Dangerous,45000000,15298133,46598133,61896266,16896266,0.37547257777777776,2008,9
13,2008-09-12,Righteous Kill,60000000,40081410,78481410,118562820,58562820,0.976047,2008,9
13,2009-10-23,Astro Boy,65000000,19551067,41636243,61187310,-3812690,-0.05865676923076923,2009,10
13,2009-11-25,Me and Orson Welles,25000000,1190003,1190003,2380006,-22619994,-0.90479976,2009,11
13,2010-01-08,Youth in Revolt,18000000,15285588,19685588,34971176,16971176,0.9428431111111111,2010,1
13,2010-01-22,La fille du RER,9000000,208163,208163,416326,-8583674,-0.9537415555555555,2010,1
13,2010-03-19,Diary of a Wimpy Kid,15000000,64003625,76954311,140957936,125957936,8.397195733333334,2010,3
13,2010-03-19,Repo Men,32000000,13942007,18195238,32137245,137245,0.00428890625,2010,3
13,2010-07-09,[Rec] 2,5600000,27766,18527766,18555532,12955532,2.313487857142857,2010,7
13,2010-12-25,Gulliver's Travels,112000000,42779261,232017848,274797109,162797109,1.4535456160714286,2010,12
13,2012-07-13,2016: Obamaâs America,2500000,33349941,33349941,66699882,64199882,25.6799528,2012,7
13,2012-11-16,Anna Karenina,49000000,12816367,71004627,83820994,34820994,0.7106325306122449,2012,11
13,2013-01-04,Promised Land,15000000,7597898,12394562,19992460,4992460,0.33283066666666666,2013,1
13,2013-03-27,G.I. Joe: Retaliation,140000000,122523060,375740705,498263765,358263765,2.5590268928571427,2013,3
13,2013-07-02,The Lone Ranger,275000000,89302115,260002115,349304230,74304230,0.2701972,2013,7
13,2013-09-27,Cloudy with a Chance of Meatballs 2,78000000,119793567,274392649,394186216,316186216,4.053669435897436,2013,9
13,2014-08-08,The Hundred-Foot Journey,22000000,54235441,94270488,148505929,126505929,5.7502695,2014,8
13,2015-03-13,Cinderella,95000000,201151353,534551353,735702706,640702706,6.744239010526316,2015,3
13,2016-09-09,Kicks,10000000,150191,150191,300382,-9699618,-0.9699618,2016,9
13,2016-12-02,Believe,3500000,890303,890303,1780606,-1719394,-0.49125542857142857,2016,12
13,2016-12-16,Collateral Beauty,36000000,31016021,85309093,116325114,80325114,2.231253166666667,2016,12
13,2017-02-24,Collide,29200000,2280004,5466698,7746702,-21453298,-0.7347019863013698,2017,2
13,2018-04-06,Lean on Pete,8000000,1163056,2455027,3618083,-4381917,-0.547739625,2018,4
13,2018-06-22,Jurassic World: Fallen Kingdom,170000000,417719760,1305772799,1723492559,1553492559,9.13819152352941,2018,6
13,2019-05-24,BrightBurn,7000000,16794432,27989498,44783930,37783930,5.397704285714286,2019,5
14,1973-12-25,The Sting,5500000,159616327,159616327,319232654,313732654,57.042300727272725,1973,12
14,1980-03-21,Mad Max,200000,8750000,99750000,108500000,108300000,541.5,1980,3
14,1982-12-08,Gandhi,22000000,52767889,127767889,180535778,158535778,7.206171727272728,1982,12
14,1983-07-29,National Lampoonâs Vacation,15000000,61400000,61400000,122800000,107800000,7.1866666666666665,1983,7
14,1986-12-19,Platoon,6000000,137963328,137978395,275941723,269941723,44.99028716666667,1986,12
14,1989-05-24,Indiana Jones and the Last Crusade,48000000,197171806,474171806,671343612,623343612,12.98632525,1989,5
14,1991-12-20,JFK,40000000,70405498,205400000,275805498,235805498,5.89513745,1991,12
14,1995-12-20,Nixon,45000000,13668249,34668249,48336498,3336498,0.0741444,1995,12
14,1999-07-02,Broken Vessels,600000,15030,85343,100373,-499627,-0.8327116666666666,1999,7
14,1999-11-24,Flawless,27000000,4485485,4485485,8970970,-18029030,-0.6677418518518519,1999,11
14,2000-04-19,La otra conquista,3500000,886410,886410,1772820,-1727180,-0.49348,2000,4
14,2000-04-21,Gossip,14000000,5108820,12591270,17700090,3700090,0.26429214285714286,2000,4
14,2000-05-26,Shanghai Noon,55000000,56932305,71189835,128122140,73122140,1.3294934545454546,2000,5
14,2001-03-30,Amores Perros,2000000,5383834,20883834,26267668,24267668,12.133834,2001,3
14,2001-10-08,Mulholland Drive,15000000,7219578,20785973,28005551,13005551,0.8670367333333333,2001,10
14,2002-05-31,Undercover Brother,25000000,38230435,40796145,79026580,54026580,2.1610632,2002,5
14,2002-10-04,Red Dragon,78000000,92955420,206455420,299410840,221410840,2.8386005128205127,2002,10
14,2002-10-25,All or Nothing,9000000,184255,184255,368510,-8631490,-0.9590544444444444,2002,10
14,2003-04-04,A Man Apart,36000000,26500000,43797731,70297731,34297731,0.95271475,2003,4
14,2003-04-25,The Real Cancun,4000000,3816594,3816594,7633188,3633188,0.908297,2003,4
14,2003-12-05,The Last Samurai,140000000,111110575,456810575,567921150,427921150,3.056579642857143,2003,12
14,2005-02-25,Cursed,35000000,19294901,25114901,44409802,9409802,0.2688514857142857,2005,2
14,2005-06-17,The Perfect Man,10000000,16535005,19535005,36070010,26070010,2.607001,2005,6
14,2005-09-16,Venom,25000000,881745,881745,1763490,-23236510,-0.9294604,2005,9
14,2007-09-14,Dragon Wars: D-War,32000000,10977721,79915361,90893082,58893082,1.8404088125,2007,9
14,2008-11-07,Soul Men,40000000,12082391,12345883,24428274,-15571726,-0.38929315,2008,11
14,2009-03-13,Sunshine Cleaning,5000000,12062558,17329337,29391895,24391895,4.878379,2009,3
14,2009-10-09,Free Style,10000000,141108,721108,862216,-9137784,-0.9137784,2009,10
14,2009-12-04,Armored,20000000,15988876,23661038,39649914,19649914,0.9824957,2009,12
14,2009-12-11,Invictus,60000000,37491364,124514011,162005375,102005375,1.7000895833333334,2009,12
14,2010-10-15,I Want Your Money,400000,433588,433588,867176,467176,1.16794,2010,10
14,2010-11-19,Made in Dagenham,8000000,1095369,15644196,16739565,8739565,1.092445625,2010,11
14,2011-04-08,Hanna,30000000,40259119,65343694,105602813,75602813,2.5200937666666667,2011,4
14,2011-11-23,Arthur Christmas,85000000,46462469,149717124,196179593,111179593,1.3079952117647058,2011,11
14,2011-12-23,We Bought a Zoo,50000000,75624550,118729073,194353623,144353623,2.88707246,2011,12
14,2012-03-09,John Carter,275000000,73058679,282778100,355836779,80836779,0.29395192363636363,2012,3
14,2012-06-01,For Greater Glory: The True Story of Cristiada,12000000,5669081,10026255,15695336,3695336,0.30794466666666664,2012,6
14,2012-06-29,Tyler Perry's Madea's Witness Protection,20000000,65653242,66950887,132604129,112604129,5.63020645,2012,6
14,2012-07-13,Ice Age: Continental Drift,95000000,161321843,879765137,1041086980,946086980,9.958810315789474,2012,7
14,2013-03-15,The Call,12800000,51872378,69821476,121693854,108893854,8.50733234375,2013,3
14,2013-05-17,Frances Ha,3000000,4067398,11262769,15330167,12330167,4.110055666666667,2013,5
14,2013-07-03,Kevin Hart: Let Me Explain,2500000,32244051,32327255,64571306,62071306,24.8285224,2013,7
14,2014-01-17,Devil's Due,7000000,15821461,36146087,51967548,44967548,6.423935428571428,2014,1
14,2014-01-24,"I, Frankenstein",65000000,19075290,74575290,93650580,28650580,0.4407781538461538,2014,1
14,2014-02-07,The Monuments Men,70000000,78031620,158702748,236734368,166734368,2.3819195428571427,2014,2
14,2014-07-25,And So It Goes,18000000,15160801,17920013,33080814,15080814,0.837823,2014,7
14,2014-08-01,Guardians of the Galaxy,170000000,333172112,770867516,1104039628,934039628,5.494350752941177,2014,8
14,2015-04-17,Unfriended,1000000,32789645,64364198,97153843,96153843,96.153843,2015,4
14,2015-05-15,Pitch Perfect 2,29000000,184296230,287625468,471921698,442921698,15.273162,2015,5
14,2017-12-15,Ferdinand,111000000,84410380,289847930,374258310,263258310,2.3716964864864867,2017,12
15,1916-12-24,"20,000 Leagues Under the Sea",200000,8000000,8000000,16000000,15800000,79.0,1916,12
15,1976-02-08,Taxi Driver,1000000,28262574,28316211,56578785,55578785,55.578785,1976,2
15,1981-09-25,Chariots of Fire,5500000,61558162,61865947,123424109,117924109,21.440747090909092,1981,9
15,1983-01-01,E tu vivrai nel terrore - L'aldilÃ,400000,126387,126387,252774,-147226,-0.368065,1983,1
15,1988-12-01,Talk Radio,4000000,3468572,3468572,6937144,2937144,0.734286,1988,12
15,1990-08-03,Mo' Better Blues,10000000,16153000,16153000,32306000,22306000,2.2306,1990,8
15,1991-05-24,Hudson Hawk,65000000,17218916,17218916,34437832,-30562168,-0.4701872,1991,5
15,1996-03-15,Executive Decision,55000000,56679192,122079192,178758384,123758384,2.2501524363636363,1996,3
15,1996-03-22,Flirting with Disaster,7000000,14853474,16149180,31002654,24002654,3.4289505714285715,1996,3
15,1996-09-06,Bogus,32000000,4357406,4357406,8714812,-23285188,-0.727662125,1996,9
15,1999-03-26,A Walk on the Moon,14000000,4741987,4741987,9483974,-4516026,-0.32257328571428573,1999,3
15,2000-02-25,Reindeer Games,36000000,23360779,23360779,46721558,10721558,0.29782105555555555,2000,2
15,2001-12-28,Black Hawk Down,95000000,108638745,159691085,268329830,173329830,1.8245245263157894,2001,12
15,2002-08-16,Blue Crush,30000000,40118420,51618420,91736840,61736840,2.057894666666667,2002,8
15,2002-10-18,The Ring,48000000,129094024,248218486,377312510,329312510,6.860677291666667,2002,10
15,2003-08-20,Thirteen,2000000,4601043,9505996,14107039,12107039,6.0535195,2003,8
15,2003-09-19,Underworld,22000000,51970690,95708457,147679147,125679147,5.7126885,2003,9
15,2004-03-05,Hidalgo,78000000,67286731,108086731,175373462,97373462,1.2483777179487179,2004,3
15,2004-06-23,Fahrenheit 9/11,6000000,119114517,221148959,340263476,334263476,55.710579333333335,2004,6
15,2004-07-28,Garden State,2500000,26782316,36028802,62811118,60311118,24.1244472,2004,7
15,2005-05-13,Mindhunters,27000000,4476235,16566235,21042470,-5957530,-0.22064925925925927,2005,5
15,2005-10-14,Where the Truth Lies,25000000,872142,1415656,2287798,-22712202,-0.90848808,2005,10
15,2005-11-18,Walk the Line,29000000,119519402,187707495,307226897,278226897,9.594030931034483,2005,11
15,2005-12-21,Fun With Dick And Jane,140000000,110550000,203018919,313568919,173568919,1.2397779928571429,2005,12
15,2006-01-27,Big Momma's House 2,40000000,70165972,137047376,207213348,167213348,4.1803337,2006,1
15,2006-11-17,For Your Consideration,12000000,5549923,5549923,11099846,-900154,-0.07501283333333333,2006,11
15,2007-08-31,Halloween,15000000,58269151,77514401,135783552,120783552,8.0522368,2007,8
15,2007-12-14,The Kite Runner,20000000,15800078,74180745,89980823,69980823,3.49904115,2007,12
15,2007-12-21,Walk Hard: The Dewey Cox Story,35000000,18317151,20606053,38923204,3923204,0.11209154285714286,2007,12
15,2008-06-06,And When Did You Last See Your Father?,8000000,1071240,2476491,3547731,-4452269,-0.556533625,2008,6
15,2009-04-17,State of Play,60000000,37017955,88832210,125850165,65850165,1.09750275,2009,4
15,2009-07-10,"I Love You, Beth Cooper",18000000,14800725,16382538,31183263,13183263,0.7324035,2009,7
15,2010-02-05,Red Riding: The Year of Our Lord 1974,9000000,148826,148826,297652,-8702348,-0.9669275555555555,2010,2
15,2010-03-31,The Last Song,20000000,62950384,92678948,155629332,135629332,6.7814666,2010,3
15,2010-04-30,Please Give,3000000,4033574,4570178,8603752,5603752,1.8679173333333334,2010,4
15,2010-05-07,Iron Man 2,170000000,312433331,621156389,933589720,763589720,4.491704235294118,2010,5
15,2010-08-27,The Last Exorcism,1800000,41034350,70165900,111200250,109400250,60.77791666666667,2010,8
15,2010-11-24,Tangled,260000000,200821936,586477240,787299176,527299176,2.028073753846154,2010,11
15,2011-09-23,Moneyball,50000000,75605492,111300835,186906327,136906327,2.73812654,2011,9
15,2012-06-01,High School,10000000,139034,248133,387167,-9612833,-0.9612833,2012,6
15,2012-09-21,Dredd,45000000,13414714,41467606,54882320,9882320,0.21960711111111111,2012,9
15,2013-12-25,August: Osage County,25000000,37738810,50738810,88477620,63477620,2.5391048,2013,12
15,2015-03-20,The Gunman,40000000,10664749,18594227,29258976,-10741024,-0.2685256,2015,3
15,2015-05-22,Drunk Wedding,600000,3301,3301,6602,-593398,-0.9889966666666666,2015,5
15,2016-01-29,Fifty Shades of Black,5000000,11686940,22113075,33800015,28800015,5.760003,2016,1
15,2016-08-05,Operation Chromite,12700000,1022720,49196532,50219252,37519252,2.954271811023622,2016,8
15,2016-09-23,Storks,70000000,72679278,183353431,256032709,186032709,2.6576101285714286,2016,9
15,2016-09-30,American Honey,3500000,663247,2611750,3274997,-225003,-0.06428657142857143,2016,9
15,2017-01-20,xXx: Return of Xander Cage,85000000,44898413,345033359,389931772,304931772,3.5874326117647057,2017,1
15,2018-05-18,Deadpool 2,110000000,324591735,786680557,1111272292,1001272292,9.102475381818182,2018,5
15,2018-06-08,Hotel Artemis,15000000,6708137,12758799,19466936,4466936,0.2977957333333333,2018,6
16,1957-12-14,A Farewell To Arms,5000000,11000000,11017403,22017403,17017403,3.4034806,1957,12
16,1969-10-24,Butch Cassidy and the Sundance Kid,6000000,102308900,102310653,204619553,198619553,33.103258833333335,1969,10
16,1971-06-30,Willy Wonka & the Chocolate Factory,3000000,4000000,4000000,8000000,5000000,1.6666666666666667,1971,6
16,1973-05-23,Pat Garrett and Billy the Kid,4638783,8000000,11000000,19000000,14361217,3.0959018777123224,1973,5
16,1976-11-16,Carrie,1800000,25878153,25878153,51756306,49956306,27.753503333333335,1976,11
16,1980-05-16,Home Movies,400000,89134,89134,178268,-221732,-0.55433,1980,5
16,1981-07-24,Blow Out,18000000,13747234,13747234,27494468,9494468,0.5274704444444445,1981,7
16,1995-07-28,The Net,22000000,50621733,110521733,161143466,139143466,6.324703,1995,7
16,1995-08-09,The Brothers McMullen,50000,10426506,10426506,20853012,20803012,416.06024,1995,8
16,1996-10-04,That Thing You Do!,2500000,25857416,34557416,60414832,57914832,23.1659328,1996,10
16,1996-10-18,Swingers,200000,4505922,6618578,11124500,10924500,54.6225,1996,10
16,1997-01-31,Waiting for Guffman,4000000,2922988,2922988,5845976,1845976,0.461494,1997,1
16,1997-03-26,Cats Don't Dance,32000000,3588602,3588602,7177204,-24822796,-0.775712375,1997,3
16,1998-09-11,Without Limits,25000000,780326,780326,1560652,-23439348,-0.93757392,1998,9
16,1998-11-13,Meet Joe Black,85000000,44650003,44650003,89300006,4300006,0.05058830588235294,1998,11
16,1998-11-20,Celebrity,12000000,5078660,6200000,11278660,-721340,-0.06011166666666667,1998,11
16,1998-12-11,Star Trek: Insurrection,70000000,70187658,117800000,187987658,117987658,1.6855379714285714,1998,12
16,1999-02-12,My Favorite Martian,60000000,36850101,36850101,73700202,13700202,0.2283367,1999,2
16,1999-08-20,Universal Soldier II: The Return,40000000,10447421,10717421,21164842,-18835158,-0.47087895,1999,8
16,1999-12-24,Snow Falling on Cedars,36000000,14378353,14378353,28756706,-7243294,-0.20120261111111112,1999,12
16,2000-12-27,Traffic,48000000,124107476,208300000,332407476,284407476,5.92515575,2000,12
16,2001-07-06,Kiss of the Dragon,25000000,36833473,36833473,73666946,48666946,1.94667784,2001,7
16,2002-01-25,Kung Pow: Enter the Fist,10000000,16033556,17033556,33067112,23067112,2.3067112,2002,1
16,2002-09-20,The Four Feathers,35000000,18306166,29882645,48188811,13188811,0.3768231714285714,2002,9
16,2003-07-11,The League of Extraordinary Gentlemen,78000000,66465204,179265204,245730408,167730408,2.150389846153846,2003,7
16,2004-01-23,Touching the Void,2000000,4593598,15396525,19990123,17990123,8.9950615,2004,1
16,2004-06-11,Garfield: The Movie,50000000,75367693,208094550,283462243,233462243,4.66924486,2004,6
16,2004-09-03,Paparazzi,20000000,15712072,16612072,32324144,12324144,0.6162072,2004,9
16,2005-02-25,Diary of a Mad Black Woman,5500000,50406346,50458356,100864702,95364702,17.339036727272727,2005,2
16,2006-05-24,An Inconvenient Truth,1000000,24146161,53365925,77512086,76512086,76.512086,2006,5
16,2006-09-30,The Queen,15000000,56441711,128885873,185327584,170327584,11.355172266666667,2006,9
16,2007-05-04,Spider-Man 3,258000000,336530303,894860230,1231390533,973390533,3.772831523255814,2007,5
16,2007-05-18,Severance,10000000,137221,5950002,6087223,-3912777,-0.3912777,2007,5
16,2007-10-19,30 Days of Night,30000000,39568996,80276156,119845152,89845152,2.9948384,2007,10
16,2008-08-20,The Rocker,15000000,6409528,8767338,15176866,176866,0.011791066666666667,2008,8
16,2008-10-17,What Just Happened,27000000,1090947,2412123,3503070,-23496930,-0.8702566666666667,2008,10
16,2009-07-31,Flammen og Citronen,9000000,148089,1635241,1783330,-7216670,-0.8018522222222222,2009,7
16,2010-04-02,Why Did I Get Married Too?,20000000,60095852,60831067,120926919,100926919,5.04634595,2010,4
16,2010-05-27,Sex and the City 2,95000000,95347692,294680778,390028470,295028470,3.1055628421052632,2010,5
16,2011-10-28,The Rum Diary,45000000,13109815,21544732,34654547,-10345453,-0.22989895555555556,2011,10
16,2013-10-04,Gravity,110000000,274092705,693698673,967791378,857791378,7.798103436363636,2013,10
16,2013-11-01,Free Birds,55000000,55750480,110387072,166137552,111137552,2.020682763636364,2013,11
16,2014-04-04,Captain America: The Winter Soldier,170000000,259746958,714401889,974148847,804148847,4.7302873352941175,2014,4
16,2014-08-22,Sin City: A Dame to Kill For,65000000,13757804,40650842,54408646,-10591354,-0.16294390769230768,2014,8
16,2014-09-12,The Drop,12600000,10724389,19054534,29778923,17178923,1.3634065873015873,2014,9
16,2014-11-14,Beyond the Lights,7000000,14618727,14618727,29237454,22237454,3.176779142857143,2014,11
16,2014-12-12,Exodus: Gods and Kings,140000000,65014513,268314513,333329026,193329026,1.3809216142857144,2014,12
16,2015-10-23,Suffragette,14000000,4702420,34044909,38747329,24747329,1.7676663571428572,2015,10
16,2016-03-18,The Bronze,3500000,615816,615816,1231632,-2268368,-0.6481051428571428,2016,3
16,2018-09-21,The House with a Clock in its Walls,40000000,68549695,126331750,194881445,154881445,3.872036125,2018,9
16,2018-09-28,Night School,29000000,77339130,103008792,180347922,151347922,5.218893862068965,2018,9
16,2019-05-03,El Chicano,8000000,700261,700261,1400522,-6599478,-0.82493475,2019,5
17,1959-01-01,Solomon and Sheba,5000000,11000000,11014961,22014961,17014961,3.4029922,1959,1
17,1964-08-26,Mary Poppins,6000000,102272145,102272145,204544290,198544290,33.090715,1964,8
17,1967-01-18,Per un pugno di dollari,200000,3500000,3516248,7016248,6816248,34.08124,1967,1
17,1981-10-30,Halloween II,2500000,25533818,25533818,51067636,48567636,19.4270544,1981,10
17,1984-11-09,A Nightmare on Elm Street,1800000,25504513,25504513,51009026,49209026,27.338347777777777,1984,11
17,1986-12-19,Little Shop of Horrors,30000000,38747385,38747385,77494770,47494770,1.583159,1986,12
17,1992-05-22,Alien 3,55000000,54927174,158500000,213427174,158427174,2.8804940727272728,1992,5
17,1992-07-31,Buffy the Vampire Slayer,7000000,14231669,14231669,28463338,21463338,3.066191142857143,1992,7
17,1993-09-24,Warlock: The Armageddon,3000000,3902679,3902679,7805358,4805358,1.601786,1993,9
17,1996-11-22,Shine,5500000,35811509,36672493,72484002,66984002,12.178909454545455,1996,11
17,1996-12-20,Ghosts of Mississippi,36000000,13052741,13052741,26105482,-9894518,-0.2748477222222222,1996,12
17,1998-01-30,Deep Rising,45000000,11203026,11203026,22406052,-22593948,-0.5020877333333333,1998,1
17,1998-10-23,La vita Ã¨ bella,20000000,57598247,229385361,286983608,266983608,13.3491804,1998,10
17,1999-09-10,Love Stinks,4000000,2793776,2793776,5587552,1587552,0.396888,1999,9
17,1999-12-08,Cradle Will Rock,32000000,2899970,2899970,5799940,-26200060,-0.818751875,1999,12
17,2001-03-16,Gabriela,50000,2335352,2335352,4670704,4620704,92.41408,2001,3
17,2001-03-30,The Tailor of Panama,18000000,13491653,27491653,40983306,22983306,1.2768503333333334,2001,3
17,2001-07-27,Jackpot,400000,44452,44452,88904,-311096,-0.77774,2001,7
17,2002-03-29,Panic Room,48000000,95308367,196308367,291616734,243616734,5.075348625,2002,3
17,2002-07-12,The Crocodile Hunter: Collision Course,12500000,28436931,33436931,61873862,49373862,3.94990896,2002,7
17,2003-01-17,A Guy Thing,20000000,15543862,17430594,32974456,12974456,0.6487228,2003,1
17,2003-06-20,From Justin to Kelly,12000000,4922166,4922166,9844332,-2155668,-0.179639,2003,6
17,2003-12-10,Big Fish,70000000,66432867,123954323,190387190,120387190,1.719817,2003,12
17,2003-12-12,The Statement,27000000,765637,1545064,2310701,-24689299,-0.9144184814814815,2003,12
17,2004-07-16,Camping Sauvage,4600000,3479302,3479302,6958604,2358604,0.51274,2004,7
17,2004-08-20,Exorcist: The Beginning,78000000,41814863,43957541,85772404,7772404,0.09964620512820513,2004,8
17,2004-11-24,Christmas with the Kranks,50000000,73701902,96469187,170171089,120171089,2.40342178,2004,11
17,2006-04-21,The Sentinel,60000000,36280697,78080697,114361394,54361394,0.9060232333333333,2006,4
17,2006-07-14,Edmond,10000000,131719,241719,373438,-9626562,-0.9626562,2006,7
17,2006-10-27,Catch a Fire,14000000,4299773,5782198,10081971,-3918029,-0.2798592142857143,2006,10
17,2006-12-22,Night at the Museum,110000000,250863268,579446407,830309675,720309675,6.548269772727273,2006,12
17,2007-10-12,Why Did I Get Married?,15000000,55204525,55934178,111138703,96138703,6.409246866666667,2007,10
17,2008-10-24,Saw V,10800000,56746769,118209778,174956547,164156547,15.199680277777778,2008,10
17,2009-08-21,Post Grad,15000000,6382178,6563402,12945580,-2054420,-0.13696133333333332,2009,8
17,2009-09-25,Pandorum,40000000,10330853,17033431,27364284,-12635716,-0.3158929,2009,9
17,2010-02-12,Percy Jackson & the Olympians: The Lightning Thief,95000000,88768303,223050874,311819177,216819177,2.2823071263157897,2010,2
17,2010-03-05,The Secret of Kells,8000000,690290,3582797,4273087,-3726913,-0.465864125,2010,3
17,2010-04-02,Leaves of Grass,9000000,70066,85527,155593,-8844407,-0.9827118888888889,2010,4
17,2010-04-30,Furry Vengeance,35000000,17630465,39340177,56970642,21970642,0.6277326285714285,2010,4
17,2010-07-30,Cats & Dogs: The Revenge of Kitty Galore,85000000,43585753,113026383,156612136,71612136,0.8424957176470588,2010,7
17,2010-10-08,Inside Job,2000000,4311834,7799257,12111091,10111091,5.0555455,2010,10
17,2011-06-10,Trolljegeren,3500000,253444,5706638,5960082,2460082,0.7028805714285714,2011,6
17,2012-08-03,Diary of a Wimpy Kid: Dog Days,22000000,49008662,77229695,126238357,104238357,4.738107136363636,2012,8
17,2013-03-22,On the Road,25000000,720828,9313302,10034130,-14965870,-0.5986348,2013,3
17,2013-08-23,You're Next,1000000,18494006,26887177,45381183,44381183,44.381183,2013,8
17,2014-05-16,Million Dollar Arm,25000000,36447959,39217912,75665871,50665871,2.02663484,2014,5
17,2014-07-11,Dawn of the Planet of the Apes,170000000,208545589,710644566,919190155,749190155,4.4070009117647055,2014,7
17,2016-03-11,The Young Messiah,16800000,6469813,7313697,13783510,-3016490,-0.1795529761904762,2016,3
17,2016-04-08,The Boss,29000000,63077560,78652207,141729767,112729767,3.887233344827586,2016,4
17,2016-05-06,Captain America: Civil War,250000000,408084349,1140069413,1548153762,1298153762,5.192615048,2016,5
17,2016-07-01,The BFG,140000000,55483770,199646680,255130450,115130450,0.8223603571428572,2016,7
17,2016-10-07,The Birth of a Nation,10000000,15861566,16891011,32752577,22752577,2.2752577,2016,10
17,2016-11-04,Hacksaw Ridge,40000000,67209615,168904682,236114297,196114297,4.902857425,2016,11
17,2016-12-25,Live by Night,65000000,10378555,21774432,32152987,-32847013,-0.5053386615384615,2016,12
18,1937-12-21,Snow White and the Seven Dwarfs,1488000,184925486,184925486,369850972,368362972,247.55576075268817,1937,12
18,1938-05-24,Alexander's Ragtime Band,2000000,4000000,4000000,8000000,6000000,3.0,1938,5
18,1965-02-15,The Greatest Story Ever Told,20000000,15473333,15473333,30946666,10946666,0.5473333,1965,2
18,1980-09-19,Ordinary People,6000000,52302978,52302978,104605956,98605956,16.434326,1980,9
18,1981-05-22,The Legend of the Lone Ranger,18000000,13400000,13400000,26800000,8800000,0.4888888888888889,1981,5
18,1982-08-20,The Beastmaster,5000000,10751126,10751126,21502252,16502252,3.3004504,1982,8
18,1982-10-22,Halloween 3: Season of the Witch,2500000,14400000,14400000,28800000,26300000,10.52,1982,10
18,1986-06-06,Invaders from Mars,12000000,4884663,4984663,9869326,-2130674,-0.17755616666666665,1986,6
18,1994-06-17,Wolf,70000000,65011757,131011757,196023514,126023514,1.8003359142857143,1994,6
18,1995-12-27,12 Monkeys,29000000,57141459,168841459,225982918,196982918,6.7925144137931035,1995,12
18,1997-01-24,Prefontaine,8000000,590817,590817,1181634,-6818366,-0.85229575,1997,1
18,1997-04-18,8 Heads in a Duffel Bag,3000000,3602884,4002884,7605768,4605768,1.535256,1997,4
18,1997-10-24,Gattaca,36000000,12532777,12532777,25065554,-10934446,-0.3037346111111111,1997,10
18,1999-08-25,In Too Deep,7000000,14026509,15471229,29497738,22497738,3.2139625714285716,1999,8
18,2000-10-27,Lucky Numbers,65000000,10014234,10014234,20028468,-44971532,-0.6918697230769231,2000,10
18,2001-03-02,The Mexican,40000000,66808615,145238250,212046865,172046865,4.301171625,2001,3
18,2001-12-28,I Am Sam,22000000,40270895,92542418,132813313,110813313,5.036968772727273,2001,12
18,2002-02-08,Collateral Damage,85000000,40048332,78353508,118401840,33401840,0.39296282352941175,2002,2
18,2003-05-30,Wrong Turn,10000000,15417771,28649556,44067327,34067327,3.4067327,2003,5
18,2003-09-26,Duplex,40000000,9652000,10070651,19722651,-20277349,-0.506933725,2003,9
18,2004-01-01,Beauty Shop,25000000,36351350,38351350,74702700,49702700,1.988108,2004,1
18,2004-11-10,The Polar Express,170000000,187224605,311365187,498589792,328589792,1.9328811294117647,2004,11
18,2004-12-10,Fabled,400000,31425,31425,62850,-337150,-0.842875,2004,12
18,2005-06-10,Mr. and Mrs. Smith,110000000,186336279,486124090,672460369,562460369,5.1132760818181815,2005,6
18,2006-03-17,V for Vendetta,50000000,70511035,130214162,200725197,150725197,3.01450394,2006,3
18,2006-09-15,Gridiron Gang,30000000,38432823,41457834,79890657,49890657,1.6630219,2006,9
18,2006-11-10,FUR: An Imaginary Portrait of Diane Arbus,16800000,223202,2281089,2504291,-14295709,-0.8509350595238095,2006,11
18,2006-11-22,Opal Dream,9000000,14443,14443,28886,-8971114,-0.9967904444444444,2006,11
18,2006-12-15,The Good German,32000000,1308696,6678033,7986729,-24013271,-0.75041471875,2006,12
18,2007-09-14,Ira and Abby,3500000,221096,221096,442192,-3057808,-0.8736594285714285,2007,9
18,2008-04-18,The Forbidden Kingdom,55000000,52075270,129075270,181150540,126150540,2.2936461818181817,2008,4
18,2009-06-19,Whatever Works,15000000,5306706,35106706,40413412,25413412,1.6942274666666666,2009,6
18,2009-08-21,Der Baader Meinhof Komplex,19700000,476270,16498827,16975097,-2724903,-0.13831994923857868,2009,8
18,2010-04-23,Joheunnom nabbeunnom isanghannom,10000000,128486,42226657,42355143,32355143,3.2355143,2010,4
18,2010-09-03,Machete,12500000,26593646,46370970,72964616,60464616,4.83716928,2010,9
18,2010-11-12,Tiny Furniture,50000,391674,424149,815823,765823,15.31646,2010,11
18,2011-02-25,The Grace Card,200000,2430735,2430735,4861470,4661470,23.30735,2011,2
18,2012-02-03,The Woman in Black,15000000,54333290,128955898,183289188,168289188,11.2192792,2012,2
18,2012-05-25,Chernobyl Diaries,1000000,18119640,42411721,60531361,59531361,59.531361,2012,5
18,2012-05-25,Les Intouchables,10800000,13182281,484873045,498055326,487255326,45.116233888888885,2012,5
18,2012-06-27,Beasts of the Southern Wild,1800000,12795746,23265132,36060878,34260878,19.033821111111113,2012,6
18,2012-08-10,The Campaign,95000000,86907746,104907746,191815492,96815492,1.0191104421052632,2012,8
18,2012-08-24,Samsara,4000000,2672413,5966671,8639084,4639084,1.159771,2012,8
18,2012-08-24,Les petits mouchoirs,25000000,205505,48530887,48736392,23736392,0.94945568,2012,8
18,2012-09-14,Barfi,4600000,2804874,36751984,39556858,34956858,7.599316956521739,2012,9
18,2012-09-21,Trouble with the Curve,60000000,35763137,47818913,83582050,23582050,0.3930341666666667,2012,9
18,2013-01-25,Parker,35000000,17616641,48543388,66160029,31160029,0.8902865428571428,2013,1
18,2013-09-27,Don Jon,5500000,24477704,41268579,65746283,60246283,10.953869636363637,2013,9
18,2013-10-18,12 Years a Slave,20000000,56671993,181025343,237697336,217697336,10.8848668,2013,10
18,2014-12-19,Mr. Turner,14000000,3958546,25187026,29145572,15145572,1.0818265714285715,2014,12
18,2015-01-09,Taken 3,48000000,89256424,327656424,416912848,368912848,7.685684333333334,2015,1
18,2016-02-26,Gods of Egypt,140000000,31153464,138836756,169990220,29990220,0.21421585714285715,2016,2
18,2016-03-25,Batman v Superman: Dawn of Justice,250000000,330360194,867500281,1197860475,947860475,3.7914419,2016,3
18,2018-12-21,Welcome to Marwen,45000000,10763520,12874922,23638442,-21361558,-0.4747012888888889,2018,12
19,1933-02-09,She Done Him Wrong,200000,2000000,2000000,4000000,3800000,19.0,1933,2
19,1964-01-29,Dr. Strangelove,1800000,9164370,9230678,18395048,16595048,9.219471111111112,1964,1
19,1968-01-01,Shalako,1455000,2620000,2620000,5240000,3785000,2.6013745704467355,1968,1
19,1973-08-22,High Plains Drifter,5500000,15700000,15700000,31400000,25900000,4.709090909090909,1973,8
19,1978-09-13,Days of Heaven,3000000,3446749,3660880,7107629,4107629,1.3692096666666667,1978,9
19,1980-05-16,The Long Riders,10000000,15198912,15198912,30397824,20397824,2.0397824,1980,5
19,1981-04-10,The Howling,1000000,17985000,17985000,35970000,34970000,34.97,1981,4
19,1983-10-28,The Wicked Lady,8000000,589308,589308,1178616,-6821384,-0.852673,1983,10
19,1988-07-20,Midnight Run,30000000,38413606,81613606,120027212,90027212,3.0009070666666666,1988,7
19,1991-11-27,My Girl,16500000,58011485,58011485,116022970,99522970,6.031695151515152,1991,11
19,1994-08-26,Police Academy 7: Mission to Moscow,10000000,126247,126247,252494,-9747506,-0.9747506,1994,8
19,1994-12-21,Little Women,15000000,50003303,50003303,100006606,85006606,5.6671070666666665,1994,12
19,1995-03-10,Outbreak,50000000,67823573,190023573,257847146,207847146,4.15694292,1995,3
19,1996-03-22,Girl 6,12000000,4880941,4880941,9761882,-2238118,-0.18650983333333335,1996,3
19,1999-08-06,The Thomas Crown Affair,48000000,69304264,124304264,193608528,145608528,3.033511,1999,8
19,2000-01-28,Isn't She Great,36000000,2954405,2954405,5908810,-30091190,-0.8358663888888889,2000,1
19,2000-07-19,The In Crowd,15000000,5217498,5217498,10434996,-4565004,-0.3043336,2000,7
19,2000-07-21,Loser,20000000,15464026,18250106,33714132,13714132,0.6857066,2000,7
19,2001-09-07,Soul Survivors,14000000,3100650,4288246,7388896,-6611104,-0.4722217142857143,2001,9
19,2002-03-15,Showtime,85000000,37948765,78948765,116897530,31897530,0.3752650588235294,2002,3
19,2002-05-03,Spider-Man,139000000,403706375,821706375,1225412750,1086412750,7.8159190647482015,2002,5
19,2002-12-13,Drumline,20000000,56398162,56398162,112796324,92796324,4.6398162,2002,12
19,2002-12-19,Antwone Fisher,12500000,21078145,23367586,44445731,31945731,2.55565848,2002,12
19,2003-04-04,What a Girl Wants,25000000,35990505,35990505,71981010,46981010,1.8792404,2003,4
19,2003-04-11,"House of 1,000 Corpses",7000000,12634962,17005466,29640428,22640428,3.234346857142857,2003,4
19,2003-09-12,Once Upon a Time in Mexico,29000000,56330657,97413527,153744184,124744184,4.301523586206897,2003,9
19,2003-10-10,Intolerable Cruelty,60000000,35327628,121327628,156655256,96655256,1.6109209333333334,2003,10
19,2004-09-17,Wimbledon,35000000,16862585,41666476,58529061,23529061,0.6722588857142857,2004,9
19,2004-12-22,The Phantom of the Opera,55000000,51225796,153770052,204995848,149995848,2.7271972363636365,2004,12
19,2005-03-04,Dear Frankie,4600000,1340891,3099369,4440260,-159740,-0.03472608695652174,2005,3
19,2005-06-17,Me and You and Everyone We Know,2000000,3885134,9615464,13500598,11500598,5.750299,2005,6
19,2005-09-23,Oliver Twist,65000000,2070920,26670920,28741840,-36258160,-0.5578178461538461,2005,9
19,2005-10-13,The Dark Hours,400000,423,423,846,-399154,-0.997885,2005,10
19,2005-11-11,Derailed,22000000,36020063,57520063,93540126,71540126,3.251823909090909,2005,11
19,2007-04-27,Jindabyne,10800000,399879,2862544,3262423,-7537577,-0.6979237962962963,2007,4
19,2007-06-22,You Kill Me,4000000,2426851,3858964,6285815,2285815,0.57145375,2007,6
19,2008-02-22,The Signal,50000,251150,406299,657449,607449,12.14898,2008,2
19,2008-10-01,Religulous,2500000,13011160,13881317,26892477,24392477,9.7569908,2008,10
19,2009-01-09,Not Easily Broken,5000000,10572742,10732909,21305651,16305651,3.2611302,2009,1
19,2009-08-28,The Final Destination,40000000,66477700,187384627,253862327,213862327,5.346558175,2009,8
19,2010-06-30,Love Ranch,25000000,137885,146149,284034,-24715966,-0.98863864,2010,6
19,2010-11-12,Unstoppable,95000000,81562942,165720921,247283863,152283863,1.6029880315789473,2010,11
19,2011-10-21,Johnny English Reborn,45000000,8406711,164640401,173047112,128047112,2.845491377777778,2011,10
19,2012-01-20,Underworld: Awakening,70000000,62321039,160379930,222700969,152700969,2.1814424142857143,2012,1
19,2012-06-01,Snow White and the Huntsman,170000000,155136755,401021746,556158501,386158501,2.271520594117647,2012,6
19,2012-12-14,The Hobbit: An Unexpected Journey,250000000,303003568,1017003568,1320007136,1070007136,4.280028544,2012,12
19,2013-08-16,Paranoia,40000000,7388654,16340767,23729421,-16270579,-0.406764475,2013,8
19,2014-01-31,Labor Day,18000000,13371528,14189810,27561338,9561338,0.5311854444444445,2014,1
19,2015-05-08,Skin Trade,9000000,1242,1242,2484,-8997516,-0.999724,2015,5
19,2015-05-29,San Andreas,110000000,155190832,456258539,611449371,501449371,4.558630645454546,2015,5
19,2016-01-08,The Masked Saint,3500000,182695,182695,365390,-3134610,-0.8956028571428571,2016,1
19,2016-02-12,The Little Prince,77500000,1311213,102028919,103340132,25840132,0.3334210580645161,2016,2
19,2016-11-23,Rules Donât Apply,26700000,3652206,3871448,7523654,-19176346,-0.7182152059925093,2016,11
19,2017-12-01,The Shape of Water,19500000,63859435,195790794,259650229,240150229,12.31539635897436,2017,12
19,2018-05-11,Breaking In,6000000,46840590,51411620,98252210,92252210,15.375368333333334,2018,5
20,1961-10-18,West Side Story,6000000,43700000,43700000,87400000,81400000,13.566666666666666,1961,10
20,1963-05-08,Dr. No,1000000,16067035,59567035,75634070,74634070,74.63407,1963,5
20,1971-01-01,Escape from the Planet of the Apes,2500000,12300000,12300000,24600000,22100000,8.84,1971,1
20,1973-01-01,Battle for the Planet of the Apes,1800000,8800000,8800000,17600000,15800000,8.777777777777779,1973,1
20,1979-01-01,The Deer Hunter,15000000,50000000,50009253,100009253,85009253,5.667283533333333,1979,1
20,1979-08-15,Apocalypse Now,31500000,78800000,81250485,160050485,128550485,4.0809677777777775,1979,8
20,1980-08-01,Raise the Titanic,40000000,7000000,7000000,14000000,-26000000,-0.65,1980,8
20,1982-02-12,La Guerre du feu,12500000,20959585,20959585,41919170,29419170,2.3535336,1982,2
20,1985-10-11,Silver Bullet,7000000,10803211,10803211,21606422,14606422,2.0866317142857143,1985,10
20,1987-12-11,Wall Street,16500000,43848100,43848100,87696200,71196200,4.314921212121212,1987,12
20,1995-06-30,Judge Dredd,85000000,34687912,113487912,148175824,63175824,0.7432449882352942,1995,6
20,1997-01-10,The Relic,60000000,33956608,33956608,67913216,7913216,0.13188693333333334,1997,1
20,1997-05-09,The Fifth Element,95000000,63570862,263898761,327469623,232469623,2.447048663157895,1997,5
20,1998-03-06,Twilight,20000000,15055091,15055091,30110182,10110182,0.5055091,1998,3
20,1999-03-12,The Corruptor,10000000,15164492,15164492,30328984,20328984,2.0328984,1999,3
20,2000-02-11,Trois,200000,1161843,1161843,2323686,2123686,10.61843,2000,2
20,2000-04-14,Keeping the Faith,29000000,37036404,45336404,82372808,53372808,1.8404416551724139,2000,4
20,2000-09-15,Bait,35000000,15325127,15471969,30797096,-4202904,-0.12008297142857143,2000,9
20,2002-05-24,Thirteen Conversations About One Thing,3000000,3287435,3705923,6993358,3993358,1.3311193333333333,2002,5
20,2003-07-01,Terminator 3: Rise of the Machines,170000000,150358296,433058296,583416592,413416592,2.431862305882353,2003,7
20,2003-08-29,Jeepers Creepers II,25000000,35623801,119923801,155547602,130547602,5.22190408,2003,8
20,2003-10-22,In the Cut,12000000,4717455,23693646,28411101,16411101,1.36759175,2003,10
20,2004-12-29,The Assassination of Richard Nixon,4600000,708776,4880143,5588919,988919,0.21498239130434782,2004,12
20,2005-12-14,Los tres entierros de Melquiades Estrada,15000000,5027684,13454474,18482158,3482158,0.23214386666666667,2005,12
20,2006-02-17,Winter Passing,3500000,107492,113783,221275,-3278725,-0.9367785714285715,2006,2
20,2006-05-05,Down in the Valley,8000000,568932,973443,1542375,-6457625,-0.807203125,2006,5
20,2006-08-11,Kabhi Alvida Naa Kehna,10750000,3275443,32575443,35850886,25100886,2.3349661395348837,2006,8
20,2008-01-25,Meet the Spartans,30000000,38233676,84646831,122880507,92880507,3.0960169,2008,1
20,2008-09-26,Miracle at St. Anna,45000000,7916887,9676497,17593384,-27406616,-0.6090359111111111,2008,9
20,2009-01-16,Paul Blart: Mall Cop,26000000,146336178,185904750,332240928,306240928,11.778497230769231,2009,1
20,2009-03-06,Watchmen,138000000,107509799,186976250,294486049,156486049,1.1339568768115942,2009,3
20,2009-03-13,Race to Witch Mountain,50000000,67172595,105103784,172276379,122276379,2.44552758,2009,3
20,2009-04-17,17 Again,40000000,64167069,139474906,203641975,163641975,4.091049375,2009,4
20,2009-05-22,Easy Virtue,14000000,2656784,20537741,23194525,9194525,0.6567517857142857,2009,5
20,2009-07-15,Harry Potter and the Half-Blood Prince,250000000,302089278,935213767,1237303045,987303045,3.94921218,2009,7
20,2009-09-18,The Informant!,22000000,33316821,41771168,75087989,53087989,2.413090409090909,2009,9
20,2010-02-19,Blood Done Sign My Name,10000000,109383,109383,218766,-9781234,-0.9781234,2010,2
20,2011-06-17,The Art of Getting By,4000000,1430241,1989035,3419276,-580724,-0.145181,2011,6
20,2011-07-29,The Smurfs,110000000,142614158,563749323,706363481,596363481,5.421486190909091,2011,7
20,2012-11-23,De rouille et dâos,19500000,2061449,29393634,31455083,11955083,0.6130811794871794,2012,11
20,2013-08-30,Getaway,18000000,10501938,11813989,22315927,4315927,0.23977372222222224,2013,8
20,2014-03-21,Muppets Most Wanted,55000000,51178893,79312301,130491194,75491194,1.3725671636363637,2014,3
20,2014-05-09,Momsâ Night Out,5000000,10429707,10537341,20967048,15967048,3.1934096,2014,5
20,2015-04-24,Yi ge ren de wu lin,25000000,129115,129115,258230,-24741770,-0.9896708,2015,4
20,2015-07-31,Counting,50000,8374,8374,16748,-33252,-0.66504,2015,7
20,2015-08-28,We Are Your Friends,2000000,3591417,10153415,13744832,11744832,5.872416,2015,8
20,2015-09-04,Tian jiang xiong shi,65000000,74070,122519874,122593944,57593944,0.8860606769230769,2015,9
20,2016-01-22,Yip Man 3,36000000,2679437,157300954,159980391,123980391,3.44389975,2016,1
20,2016-06-03,Me Before You,20000000,56245075,208265198,264510273,244510273,12.22551365,2016,6
20,2017-09-22,The Lego Ninjago Movie,70000000,59281555,122737201,182018756,112018756,1.600267942857143,2017,9
20,2018-09-28,Hell Fest,5500000,11107431,18119231,29226662,23726662,4.313938545454546,2018,9
20,2018-11-16,Instant Family,48000000,67363237,119736188,187099425,139099425,2.8979046875,2018,11
20,2018-11-30,Werk ohne Autor,1400000,1303747,4331152,5634899,4234899,3.024927857142857,2018,11
21,1951-09-18,A Streetcar Named Desire,1800000,8000000,8000000,16000000,14200000,7.888888888888889,1951,9
21,1956-10-17,Around the World in 80 Days,6000000,42000000,42000000,84000000,78000000,13.0,1956,10
21,1963-05-29,Hud,2500000,10000000,10000000,20000000,17500000,7.0,1963,5
21,1964-08-11,A Hard Day's Night,560000,1537860,1626784,3164644,2604644,4.65115,1964,8
21,1979-05-25,Alien,10700000,80930630,203628947,284559577,273859577,25.594352990654205,1979,5
21,1987-09-18,Hellraiser,1000000,14564000,14575148,29139148,28139148,28.139148,1987,9
21,1987-11-13,The Running Man,30000000,38122000,38122000,76244000,46244000,1.5414666666666668,1987,11
21,1995-03-31,Jefferson in Paris,14000000,2461628,2461628,4923256,-9076744,-0.6483388571428571,1995,3
21,1995-12-11,Sense and Sensibility,16500000,42993774,134993774,177987548,161487548,9.787124121212122,1995,12
21,1996-12-25,Evita,55000000,50047179,151947179,201994358,146994358,2.6726246909090907,1996,12
21,1997-09-26,The Ice Storm,18000000,8038061,16011975,24050036,6050036,0.3361131111111111,1997,9
21,1998-04-03,Mercury Rising,60000000,32983332,32983332,65966664,5966664,0.0994444,1998,4
21,1999-09-24,Jakob the Liar,15000000,4956401,4956401,9912802,-5087198,-0.33914653333333333,1999,9
21,1999-11-05,The Bone Collector,48000000,66488090,151463090,217951180,169951180,3.5406495833333334,1999,11
21,2000-03-31,The Road to El Dorado,95000000,50802661,65700000,116502661,21502661,0.2263438,2000,3
21,2000-12-08,Dungeons and Dragons,35000000,15185241,33771965,48957206,13957206,0.3987773142857143,2000,12
21,2002-04-05,Big Trouble,45000000,7262288,8488871,15751159,-29248841,-0.6499742444444444,2002,4
21,2002-11-22,The Emperor's Club,12500000,14060950,16193713,30254663,17754663,1.42037304,2002,11
21,2003-06-06,Mambo Italiano,5500000,9282750,12399772,21682522,16182522,2.9422767272727275,2003,6
21,2003-08-06,Freaky Friday,26000000,110222438,160822438,271044876,245044876,9.424802923076923,2003,8
21,2003-10-10,House of the Dead,7000000,10199354,13860078,24059432,17059432,2.4370617142857145,2003,10
21,2004-05-07,Van Helsing,170000000,120150546,300150546,420301092,250301092,1.4723593647058824,2004,5
21,2004-09-24,The Forgotten,50000000,66711892,117211892,183923784,133923784,2.67847568,2004,9
21,2005-03-25,D.E.B.S.,3500000,96793,96793,193586,-3306414,-0.9446897142857142,2005,3
21,2005-07-29,Stealth,138000000,32116746,76416746,108533492,-29466508,-0.21352542028985508,2005,7
21,2005-09-16,Thumbsucker,4000000,1328679,1919197,3247876,-752124,-0.188031,2005,9
21,2006-11-10,Harsh Times,2000000,3337931,6225304,9563235,7563235,3.7816175,2006,11
21,2006-12-20,The Painted Veil,19400000,8060487,15118795,23179282,3779282,0.1948083505154639,2006,12
21,2007-03-02,Zodiac,85000000,33080084,83080084,116160168,31160168,0.3665902117647059,2007,3
21,2007-05-11,Brooklyn Rules,8000000,458232,458232,916464,-7083536,-0.885442,2007,5
21,2007-06-27,Live Free or Die Hard,110000000,134529403,382288147,516817550,406817550,3.698341363636364,2007,6
21,2008-02-22,Charlie Bartlett,12000000,3950294,5295909,9246203,-2753797,-0.22948308333333334,2008,2
21,2009-08-14,"The Goods: Live Hard, Sell Hard",10000000,15122676,15297318,30419994,20419994,2.0419994,2009,8
21,2009-09-23,Capitalism: A Love Story,20000000,14363397,19121531,33484928,13484928,0.6742464,2009,9
21,2010-02-19,The Good Guy,10000000,100688,106460,207148,-9792852,-0.9792852,2010,2
21,2011-02-18,Unknown,40000000,63686397,136123083,199809480,159809480,3.995237,2011,2
21,2011-05-06,There Be Dragons,36000000,1069334,4020990,5090324,-30909676,-0.8586021111111111,2011,5
21,2011-06-24,Le nom des gens,4600000,514237,9261711,9775948,5175948,1.1252060869565217,2011,6
21,2013-11-22,Delivery Man,22000000,30659817,70536870,101196687,79196687,3.599849409090909,2013,11
21,2013-12-13,The Hobbit: The Desolation of Smaug,250000000,258366855,960366855,1218733710,968733710,3.87493484,2013,12
21,2014-10-10,Dracula Untold,70000000,55991880,220241723,276233603,206233603,2.9461943285714285,2014,10
21,2015-06-19,The Overnight,200000,1109808,1165996,2275804,2075804,10.37902,2015,6
21,2015-07-10,Baahubali: The Beginning,40000000,6738000,26736665,33474665,-6525335,-0.163133375,2015,7
21,2015-11-20,Mustang,1400000,845464,5552584,6398048,4998048,3.5700342857142857,2015,11
21,2016-04-15,Criminal,31500000,14708696,38771262,53479958,21979958,0.6977764444444444,2016,4
21,2016-04-22,Compadres,3000000,3127773,7445044,10572817,7572817,2.5242723333333332,2016,4
21,2017-03-17,The Belko Experiment,5000000,10166820,11792942,21959762,16959762,3.3919524,2017,3
21,2017-08-18,Logan Lucky,29000000,27778642,44264271,72042913,43042913,1.4842383793103449,2017,8
21,2018-07-20,The Equalizer 2,77000000,102084362,190453132,292537494,215537494,2.799188233766234,2018,7
21,2018-08-10,BlacKkKlansman,15000000,49275340,93017335,142292675,127292675,8.486178333333333,2018,8
21,2018-09-07,Peppermint,25000000,35418723,51800758,87219481,62219481,2.48877924,2018,9
21,2019-02-08,What Men Want,20000000,54611903,69911903,124523806,104523806,5.2261903,2019,2
22,1968-08-03,Hang 'em High,1800000,6800000,6800000,13600000,11800000,6.555555555555555,1968,8
22,1980-07-25,Caddyshack,6000000,39846344,39846344,79692688,73692688,12.282114666666667,1980,7
22,1982-06-04,Poltergeist,10700000,74706019,121706019,196412038,185712038,17.35626523364486,1982,6
22,1993-09-10,True Romance,12500000,12281000,12309980,24590980,12090980,0.9672784,1993,9
22,1999-02-19,Jawbreaker,3000000,3076820,3076820,6153640,3153640,1.0512133333333333,1999,2
22,1999-10-01,Three Kings,48000000,60652036,107752036,168404072,120404072,2.5084181666666665,1999,10
22,2000-03-03,Ghost Dog: The Way of the Samurai,2000000,3330230,10672492,14002722,12002722,6.001361,2000,3
22,2000-09-15,Almost Famous,60000000,32522352,47371191,79893543,19893543,0.33155905,2000,9
22,2001-07-20,Ghost World,5500000,6217849,8761608,14979457,9479457,1.7235376363636363,2001,7
22,2003-10-24,The Singing Detective,8000000,336456,524747,861203,-7138797,-0.892349625,2003,10
22,2004-10-15,Being Julia,18000000,7739049,14488705,22227754,4227754,0.23487522222222224,2004,10
22,2004-10-22,Short Cut to Nirvana: Kumbh Mela,200000,381225,439651,820876,620876,3.10438,2004,10
22,2005-04-29,The Holy Girl,1400000,304124,1261792,1565916,165916,0.11851142857142857,2005,4
22,2005-06-22,Herbie: Fully Loaded,50000000,66010682,144110682,210121364,160121364,3.20242728,2005,6
22,2005-08-19,The 40 Year-old Virgin,26000000,109449237,177344230,286793467,260793467,10.030517961538461,2005,8
22,2006-02-03,When a Stranger Calls,15000000,47860214,67215435,115075649,100075649,6.671709933333333,2006,2
22,2006-07-14,Little Man,64000000,58636047,101636047,160272094,96272094,1.50425146875,2006,7
22,2006-08-18,The Illusionist,16500000,39868642,83792062,123660704,107160704,6.4945881212121215,2006,8
22,2006-09-29,The Guardian,70000000,55011732,94973540,149985272,79985272,1.142646742857143,2006,9
22,2006-12-21,Man cheng jin dai huang jin jia,45000000,6566773,76904429,83471202,38471202,0.8549156,2006,12
22,2007-09-21,Good Luck Chuck,25000000,35017297,59183821,94201118,69201118,2.76804472,2007,9
22,2007-09-28,Se jie,15000000,4604982,65167430,69772412,54772412,3.6514941333333333,2007,9
22,2007-11-09,Lions for Lambs,35000000,14998070,63211088,78209158,43209158,1.2345473714285715,2007,11
22,2008-05-28,Savage Grace,4600000,434417,968805,1403222,-3196778,-0.6949517391304347,2008,5
22,2008-06-13,The Incredible Hulk,137500000,134806913,265573859,400380772,262880772,1.91186016,2008,6
22,2009-02-13,Two Lovers,12000000,3149034,16349034,19498068,7498068,0.624839,2009,2
22,2009-10-02,A Serious Man,7000000,9228788,30360570,39589358,32589358,4.655622571428571,2009,10
22,2009-10-23,Motherhood,10000000,93388,723388,816776,-9183224,-0.9183224,2009,10
22,2009-12-11,The Lovely Bones,95000000,44114232,94894448,139008680,44008680,0.4632492631578947,2009,12
22,2010-06-04,Get Him to the Greek,40000000,61153526,91455875,152609401,112609401,2.815235025,2010,6
22,2010-08-06,Flipped,14000000,1755212,4289993,6045205,-7954795,-0.5681996428571429,2010,8
22,2010-08-13,Scott Pilgrim vs. The World,85000000,31611316,48056764,79668080,-5331920,-0.06272847058823529,2010,8
22,2011-07-29,The Harvest/La Cosecha,560000,3709,3709,7418,-552582,-0.9867535714285715,2011,7
22,2011-09-23,Red State,4000000,1065429,1983596,3049025,-950975,-0.23774375,2011,9
22,2011-11-23,My Week with Marilyn,10000000,14597405,34240572,48837977,38837977,3.8837977,2011,11
22,2012-04-13,Lockout,20000000,14326865,33943049,48269914,28269914,1.4134957,2012,4
22,2013-04-12,42,31000000,95020213,97470701,192490914,161490914,5.209384322580645,2013,4
22,2013-07-03,Despicable Me 2,76000000,368065385,975216835,1343282220,1267282220,16.67476605263158,2013,7
22,2013-08-02,The Spectacular Now,2500000,6852971,6916951,13769922,11269922,4.5079688,2013,8
22,2013-09-13,The Family,30000000,36918811,51078541,87997352,57997352,1.9332450666666667,2013,9
22,2014-12-17,The Hobbit: The Battle of the Five Armies,250000000,255119788,945577621,1200697409,950697409,3.802789636,2014,12
22,2015-03-20,The Divergent Series: Insurgent,110000000,130179072,295075882,425254954,315254954,2.8659541272727274,2015,3
22,2016-02-05,"Hail, Caesar!",22000000,30080225,64160680,94240905,72240905,3.2836775,2016,2
22,2016-03-11,"Hello, My Name is Doris",1000000,14444999,14662703,29107702,28107702,28.107702,2016,3
22,2016-03-11,The Perfect Match,5000000,9669521,10182050,19851571,14851571,2.9703142,2016,3
22,2016-04-15,Barbershop: The Next Cut,20000000,54030051,54404202,108434253,88434253,4.42171265,2016,4
22,2016-06-03,Time to Choose,3500000,29233,29233,58466,-3441534,-0.9832954285714286,2016,6
22,2016-08-12,Florence Foster Jenkins,29000000,27383770,56000339,83384109,54384109,1.8753141034482759,2016,8
22,2016-08-19,Kubo and the Two Strings,55000000,48023088,77548122,125571210,70571210,1.283112909090909,2016,8
22,2018-03-09,The Hurricane Heist,40000000,6115824,30963684,37079508,-2920492,-0.0730123,2018,3
22,2019-03-29,Dumbo,170000000,113883318,345004422,458887740,288887740,1.6993396470588236,2019,3
23,1978-01-01,Caravans,14000000,1000000,1000000,2000000,-12000000,-0.8571428571428571,1978,1
23,1989-03-22,Troop Beverly Hills,18000000,7190505,7190505,14381010,-3618990,-0.201055,1989,3
23,1989-08-09,The Abyss,70000000,54243125,54243125,108486250,38486250,0.5498035714285714,1989,8
23,1990-12-07,Edward Scissorhands,20000000,53976987,53976987,107953974,87953974,4.3976987,1990,12
23,1991-01-18,Flight of the Intruder,35000000,14471440,14471440,28942880,-6057120,-0.17306057142857142,1991,1
23,1991-09-29,My Own Private Idaho,2500000,6401336,6401336,12802672,10302672,4.1210688,1991,9
23,1996-08-09,Basquiat,3000000,2962051,2962051,5924102,2924102,0.9747006666666667,1996,8
23,1998-02-13,The Borrowers,29000000,22619589,54045832,76665421,47665421,1.6436352068965516,1998,2
23,1998-09-25,Ronin,55000000,41610884,70692101,112302985,57302985,1.0418724545454545,1998,9
23,1998-12-11,Shakespeare in Love,26000000,100317794,279500000,379817794,353817794,13.608376692307692,1998,12
23,1999-06-18,An Ideal Husband,10700000,18542974,31341183,49884157,39184157,3.6620707476635515,1999,6
23,1999-10-08,Random Hearts,64000000,31054924,63200000,94254924,30254924,0.4727331875,1999,10
23,2000-10-06,Digimon: The Movie,5000000,9628751,16628751,26257502,21257502,4.2515004,2000,10
23,2001-03-23,The Brothers,6000000,27457409,27958191,55415600,49415600,8.235933333333334,2001,3
23,2001-08-24,Jay and Silent Bob Strike Back,22000000,30059386,33762400,63821786,41821786,1.9009902727272727,2001,8
23,2001-12-14,Iris,5500000,5580479,5580479,11160958,5660958,1.029265090909091,2001,12
23,2002-01-04,Impostor,40000000,6114237,7974607,14088844,-25911156,-0.6477789,2002,1
23,2002-02-08,Big Fat Liar,15000000,47811275,52461017,100272292,85272292,5.684819466666666,2002,2
23,2002-11-15,El crimen de padre Amaro,1800000,5719000,5719000,11438000,9638000,5.354444444444445,2002,11
23,2003-02-07,Shanghai Knights,50000000,60470220,88316835,148787055,98787055,1.9757411,2003,2
23,2003-02-28,Cradle 2 the Grave,25000000,34657731,56434942,91092673,66092673,2.64370692,2003,2
23,2003-03-28,Head of State,35200000,37788228,38283765,76071993,40871993,1.1611361647727272,2003,3
23,2003-03-28,The Core,85000000,31111260,74132631,105243891,20243891,0.23816342352941178,2003,3
23,2003-06-06,2 Fast 2 Furious,76000000,127120058,236410607,363530665,287530665,3.7832982236842105,2003,6
23,2003-06-20,Hulk,137000000,132177234,245075434,377252668,240252668,1.753669109489051,2003,6
23,2003-11-21,Gothika,40000000,59588068,141484812,201072880,161072880,4.026822,2003,11
23,2004-10-15,Eulogy,10000000,70527,70527,141054,-9858946,-0.9858946,2004,10
23,2004-12-10,Ocean's Twelve,110000000,125531634,362989076,488520710,378520710,3.4410973636363638,2004,12
23,2005-09-16,Cry Wolf,1000000,10047674,15943081,25990755,24990755,24.990755,2005,9
23,2005-09-30,MirrorMask,4000000,864959,973613,1838572,-2161428,-0.540357,2005,9
23,2005-10-21,"Kiss Kiss, Bang Bang",15000000,4235837,16829464,21065301,6065301,0.4043534,2005,10
23,2007-06-15,Fido,8000000,298110,456814,754924,-7245076,-0.9056345,2007,6
23,2007-08-03,Becoming Jane,16500000,18663911,39380876,58044787,41544787,2.517865878787879,2007,8
23,2007-10-19,Out of the Blue,4600000,728,731767,732495,-3867505,-0.8407619565217391,2007,10
23,2007-11-16,Love in the Time of Cholera,45000000,4617608,31077418,35695026,-9304974,-0.2067772,2007,11
23,2008-08-29,Disaster Movie,20000000,14190901,36720752,50911653,30911653,1.54558265,2008,8
23,2009-06-26,Surveillance,3500000,27349,1396395,1423744,-2076256,-0.593216,2009,6
23,2009-09-11,Sorority Row,12500000,11965282,26735797,38701079,26201079,2.09608632,2009,9
23,2010-01-22,Tooth Fairy,48000000,60022256,112610386,172632642,124632642,2.596513375,2010,1
23,2010-07-30,Get Low,7000000,9176933,10828305,20005238,13005238,1.857891142857143,2010,7
23,2011-07-29,The Devil's Double,19100000,1361512,5965646,7327158,-11772842,-0.616379162303665,2011,7
23,2012-10-12,Middle of Nowhere,200000,236806,236806,473612,273612,1.36806,2012,10
23,2012-11-02,Flight,31000000,93772375,160558438,254330813,223330813,7.2042197741935485,2012,11
23,2013-11-15,La grande bellezza,12000000,2883879,29549145,32433024,20433024,1.702752,2013,11
23,2014-10-03,La chambre bleue,1400000,260441,1945420,2205861,805861,0.575615,2014,10
23,2014-12-25,Big Eyes,10000000,14482031,27317872,41799903,31799903,3.1799903,2014,12
23,2015-05-22,Tomorrowland,170000000,93436322,206627518,300063840,130063840,0.7650814117647059,2015,5
23,2015-09-18,Captive,2000000,2583301,2791973,5375274,3375274,1.687637,2015,9
23,2016-08-19,Ben-Hur,95000000,26410477,91669648,118080125,23080125,0.24294868421052632,2016,8
23,2017-04-14,The Fate of the Furious,250000000,225764765,1234846267,1460611032,1210611032,4.842444128,2017,4
23,2018-02-09,The 15:17 to Paris,30000000,36276286,56096200,92372486,62372486,2.0790828666666665,2018,2
23,2019-02-08,Cold Pursuit,60000000,32138862,62599159,94738021,34738021,0.5789670166666666,2019,2
24,1931-12-26,Mata Hari,558000,900000,900000,1800000,1242000,2.225806451612903,1931,12
24,1980-06-06,Galaxina,5500000,4865000,4865000,9730000,4230000,0.769090909090909,1980,6
24,1984-03-23,Police Academy,4500000,81198894,81198894,162397788,157897788,35.08839733333333,1984,3
24,1985-07-03,Back to the Future,19000000,212259762,385524784,597784546,578784546,30.46234452631579,1985,7
24,1986-02-21,Nine 1/2 Weeks,18000000,6734844,6734844,13469688,-4530312,-0.251684,1986,2
24,1987-03-31,The Barbarians,4000000,800000,800000,1600000,-2400000,-0.6,1987,3
24,1990-12-21,Kindergarten Cop,26000000,91457688,202000000,293457688,267457688,10.286834153846154,1990,12
24,1992-09-30,Glengarry Glen Ross,12500000,10725228,10725228,21450456,8950456,0.71603648,1992,9
24,1993-12-29,Shadowlands,22000000,25842377,25842377,51684754,29684754,1.349307,1993,12
24,1995-01-27,Before Sunrise,2500000,5274005,5690220,10964225,8464225,3.38569,1995,1
24,1995-12-29,Mr. Hollandâs Opus,31000000,82582604,106282604,188865208,157865208,5.092426064516129,1995,12
24,1997-05-09,Father's Day,85000000,28681080,35681080,64362160,-20637840,-0.24279811764705883,1997,5
24,1997-08-15,Cop Land,15000000,44906632,63706632,108613264,93613264,6.240884266666667,1997,8
24,1997-11-21,Mortal Kombat: Annihilation,30000000,35927406,51327406,87254812,57254812,1.9084937333333334,1997,11
24,1997-12-19,Tomorrow Never Dies,110000000,125304276,339504276,464808552,354808552,3.225532290909091,1997,12
24,1999-04-30,Idle Hands,15000000,4023741,4023741,8047482,-6952518,-0.4635012,1999,4
24,1999-09-17,Taxman,3500000,9871,9871,19742,-3480258,-0.9943594285714286,1999,9
24,2000-08-18,Godzilla 2000,1000000,10037390,10037390,20074780,19074780,19.07478,2000,8
24,2001-06-15,Songcatcher,1800000,3050934,3050934,6101868,4301868,2.3899266666666668,2001,6
24,2001-07-11,Final Fantasy: The Spirits Within,137000000,32131830,85131830,117263660,-19736340,-0.14406087591240876,2001,7
24,2001-08-17,Rat Race,48000000,56607223,86607223,143214446,95214446,1.9836342916666667,2001,8
24,2001-11-30,Behind Enemy Lines,40000000,58855732,58855732,117711464,77711464,1.9427866,2001,11
24,2002-02-15,Last Orders,12000000,2326407,2326407,4652814,-7347186,-0.6122655,2002,2
24,2002-08-02,Full Frontal,2000000,2512846,3438804,5951650,3951650,1.975825,2002,8
24,2002-12-06,Analyze That,60000000,32122249,54994757,87117006,27117006,0.4519501,2002,12
24,2002-12-25,Pinocchio,45000000,3681811,31681811,35363622,-9636378,-0.21414173333333333,2002,12
24,2003-12-19,House of Sand and Fog,16500000,13005485,16157923,29163408,12663408,0.7674792727272727,2003,12
24,2004-05-28,Saved!,5000000,8886160,10206551,19092711,14092711,2.8185422,2004,5
24,2004-09-17,Incident at Loch Ness,1400000,36830,56073,92903,-1307097,-0.9336407142857143,2004,9
24,2004-12-25,Darkness,10600000,22163442,34409206,56572648,45972648,4.337042264150943,2004,12
24,2005-08-05,Broken Flowers,10000000,13744960,40744960,54489920,44489920,4.448992,2005,8
24,2006-02-24,Tsotsi,3000000,2912606,11537539,14450145,11450145,3.816715,2006,2
24,2006-03-17,She's the Man,25000000,33889159,55279608,89168767,64168767,2.56675068,2006,3
24,2006-06-28,Superman Returns,232000000,200120000,374085065,574205065,342205065,1.4750218318965518,2006,6
24,2006-12-25,Children of Men,76000000,35552383,69845011,105397394,29397394,0.3868078157894737,2006,12
24,2006-12-27,Perfume: The Story of a Murderer,63700000,2223293,133603463,135826756,72126756,1.1322881632653061,2006,12
24,2008-10-10,Call+Response,200000,212989,212989,425978,225978,1.12989,2008,10
24,2008-12-05,Frost/Nixon,29000000,18622031,28452945,47074976,18074976,0.6232750344827587,2008,12
24,2008-12-17,The Wrestler,6000000,26238243,46634275,72872518,66872518,11.145419666666667,2008,12
24,2009-12-11,A Single Man,7000000,9176000,28142379,37318379,30318379,4.331197,2009,12
24,2010-06-25,Les herbes folles,14000000,403952,1903952,2307904,-11692096,-0.8351497142857143,2010,6
24,2010-09-24,Wall Street 2: Money Never Sleeps,70000000,52474616,137431619,189906235,119906235,1.7129462142857144,2010,9
24,2010-11-24,Burlesque,55000000,39440655,90552675,129993330,74993330,1.363515090909091,2010,11
24,2011-05-27,The Tree of Life,35000000,13305665,61721826,75027491,40027491,1.1436426,2011,5
24,2011-09-30,What's Your Number?,20000000,14011084,30163785,44174869,24174869,1.20874345,2011,9
24,2012-05-18,Polisse,8900000,176988,22744132,22921120,14021120,1.5754067415730337,2012,5
24,2014-07-18,Planes: Fire and Rescue,50000000,59157732,156399644,215557376,165557376,3.31114752,2014,7
24,2014-11-07,Elsa & Fred,10000000,67657,197901,265558,-9734442,-0.9734442,2014,11
24,2015-02-06,Seventh Son,95000000,17725785,108874967,126600752,31600752,0.3326394947368421,2015,2
24,2015-11-25,Victor Frankenstein,40000000,5775076,31124367,36899443,-3100557,-0.077513925,2015,11
24,2017-09-08,It,35000000,327481748,697457969,1024939717,989939717,28.283991914285714,2017,9
24,2018-09-14,A Simple Favor,20000000,53548586,97628717,151177303,131177303,6.55886515,2018,9
24,2018-10-26,London Fields,8000000,252676,433732,686408,-7313592,-0.914199,2018,10
24,2019-02-14,Alita: Battle Angel,170000000,85710210,402976036,488686246,318686246,1.8746249764705882,2019,2
25,1929-02-01,The Broadway Melody,379000,2800000,4358000,7158000,6779000,17.886543535620053,1929,2
25,1980-05-09,Friday the 13th,550000,39754601,59754601,99509202,98959202,179.92582181818182,1980,5
25,1985-12-18,Out of Africa,31000000,79096868,258210860,337307728,306307728,9.880894451612903,1985,12
25,1989-06-30,Do the Right Thing,6000000,26004026,26004026,52008052,46008052,7.668008666666666,1989,6
25,1990-11-09,Dances with Wolves,19000000,184208842,424200000,608408842,589408842,31.021518,1990,11
25,1991-01-10,Warlock,7000000,8824553,8824553,17649106,10649106,1.5213008571428572,1991,1
25,1993-06-11,Jurassic Park,63000000,395708305,1038812584,1434520889,1371520889,21.77017284126984,1993,6
25,1994-03-09,Four Weddings and a Funeral,4500000,52700832,242895809,295596641,291096641,64.68814244444444,1994,3
25,1996-10-11,The Ghost and the Darkness,55000000,38564422,38564422,77128844,22128844,0.40234261818181816,1996,10
25,1997-01-31,Shadow Conspiracy,45000000,2154540,2154540,4309080,-40690920,-0.9042426666666666,1997,1
25,1997-11-14,The Man Who Knew Too Little,20000000,13801755,13801755,27603510,7603510,0.3801755,1997,11
25,1997-12-25,Wag the Dog,15000000,43057470,64252038,107309508,92309508,6.1539672,1997,12
25,1998-02-27,An Alan Smithee Film: Burn Hollywood Burn,10000000,45779,45779,91558,-9908442,-0.9908442,1998,2
25,2000-06-28,The Patriot,110000000,113330342,215300000,328630342,218630342,1.9875485636363637,2000,6
25,2000-06-30,The Adventures of Rocky & Bullwinkle,76000000,26000610,35129610,61130220,-14869780,-0.195655,2000,6
25,2001-08-17,American Outlaws,35000000,13264986,13601109,26866095,-8133905,-0.23239728571428572,2001,8
25,2002-05-10,The Business of Fancy Dancing,200000,174682,174682,349364,149364,0.74682,2002,5
25,2002-06-28,Hey Arnold! The Movie,10000000,13684949,13684949,27369898,17369898,1.7369898,2002,6
25,2002-11-27,Extreme Ops,40000000,4835968,12624471,17460439,-22539561,-0.563489025,2002,11
25,2003-01-24,Amen,14000000,274299,274299,548598,-13451402,-0.9608144285714286,2003,1
25,2003-05-09,Les invasions barbares,5000000,8460000,25913869,34373869,29373869,5.8747738,2003,5
25,2003-05-30,Finding Nemo,94000000,380529370,936429370,1316958740,1222958740,13.010199361702128,2003,5
25,2004-11-12,Seed of Chucky,29000000,17016190,24716190,41732380,12732380,0.43904758620689655,2004,11
25,2004-11-26,Les Choristes,5500000,3629758,83529758,87159516,81659516,14.847184727272728,2004,11
25,2006-02-10,Curious George,50000000,58640119,71052604,129692723,79692723,1.59385446,2006,2
25,2007-03-09,Gwoemul,12000000,2201923,92618117,94820040,82820040,6.90167,2007,3
25,2007-09-07,3:10 to Yuma,48000000,53606916,71171825,124778741,76778741,1.5995571041666667,2007,9
25,2007-09-21,Sydney White,16500000,11892415,13636339,25528754,9028754,0.5471972121212121,2007,9
25,2008-08-06,Pineapple Express,26000000,87341380,102404019,189745399,163745399,6.297899961538461,2008,8
25,2008-08-27,Traitor,22000000,23530831,27882226,51413057,29413057,1.3369571363636363,2008,8
25,2008-11-07,The Boy in the Striped Pyjamas,12500000,9046156,44083403,53129559,40629559,3.25036472,2008,11
25,2009-04-24,The Soloist,60000000,31853584,38522450,70376034,10376034,0.1729339,2009,4
25,2009-06-05,The Hangover,35000000,277322503,465764086,743086589,708086589,20.2310454,2009,6
25,2010-01-15,The Last Station,18000000,6617867,15696146,22314013,4314013,0.2396673888888889,2010,1
25,2010-04-09,Letters to God,3000000,2848587,3237452,6086039,3086039,1.0286796666666667,2010,4
25,2010-12-29,Blue Valentine,1000000,9737892,16566240,26304132,25304132,25.304132,2010,12
25,2011-01-14,The Dilemma,70000000,48475290,70546865,119022155,49022155,0.7003165,2011,1
25,2011-03-18,The Lincoln Lawyer,40000000,58009200,87145086,145154286,105154286,2.62885715,2011,3
25,2011-07-01,Larry Crowne,30000000,35608245,61449135,97057380,67057380,2.235246,2011,7
25,2011-08-23,Higher Ground,1800000,841056,842693,1683749,-116251,-0.06458388888888889,2011,8
25,2011-09-16,Restless,8000000,163753,2772511,2936264,-5063736,-0.632967,2011,9
25,2012-10-17,Holy Motors,4000000,641054,4230426,4871480,871480,0.21787,2012,10
25,2012-11-16,"The Twilight Saga: Breaking Dawn, Part 2",136200000,292324737,829724737,1122049474,985849474,7.238248707782673,2012,11
25,2013-04-05,Eddie: The Sleepwalking Cannibal,1400000,1632,1632,3264,-1396736,-0.9976685714285715,2013,4
25,2013-12-06,The Last Days on Mars,10600000,24084,261364,285448,-10314552,-0.9730709433962265,2013,12
25,2014-12-10,The Gambler,25000000,33680992,38718031,72399023,47399023,1.89596092,2014,12
25,2015-01-09,Selma,20000000,52076908,66776576,118853484,98853484,4.9426742,2015,1
25,2015-10-30,Scouts Guide to the Zombie Apocalypse,15000000,3703046,15554855,19257901,4257901,0.2838600666666667,2015,10
25,2015-11-13,Heist,8900000,50136,3324131,3374267,-5525733,-0.6208688764044944,2015,11
25,2016-06-24,Hunt for the Wilderpeople,2500000,5205471,23845533,29051004,26551004,10.6204016,2016,6
25,2017-05-26,Pirates of the Caribbean: Dead Men Tell No Tales,230000000,172558876,788241137,960800013,730800013,3.1773913608695654,2017,5
25,2017-12-20,The Greatest Showman,84000000,174340174,386665550,561005724,477005724,5.678639571428572,2017,12
25,2018-06-08,Hearts Beat Loud,2000000,2386254,2420962,4807216,2807216,1.403608,2018,6
25,2019-05-31,Godzilla: King of the Monsters,170000000,85576941,299276941,384853882,214853882,1.2638463647058824,2019,5
26,1976-03-11,Robin and Marian,5000000,8000000,8000000,16000000,11000000,2.2,1976,3
26,1979-06-29,Moonraker,31000000,70300000,210300000,280600000,249600000,8.051612903225806,1979,6
26,1980-06-20,The Blue Lagoon,4500000,47923795,47923795,95847590,91347590,20.299464444444446,1980,6
26,1980-12-12,Popeye,20000000,49823037,49823037,99646074,79646074,3.9823037,1980,12
26,1981-06-26,Dragonslayer,18000000,6000000,6000000,12000000,-6000000,-0.3333333333333333,1981,6
26,1981-07-10,Escape from New York,6000000,25244700,25245925,50490625,44490625,7.415104166666667,1981,7
26,1981-11-13,The Pursuit of D.B. Cooper,12000000,2104164,2104164,4208328,-7791672,-0.649306,1981,11
26,1982-04-02,Cat People,12500000,7000000,21000000,28000000,15500000,1.24,1982,4
26,1982-06-11,ET: The Extra-Terrestrial,10500000,435110554,792965326,1228075880,1217575880,115.95960761904762,1982,6
26,1983-04-15,The Evil Dead,375000,2400000,29400000,31800000,31425000,83.8,1983,4
26,1984-04-27,Love Letters,550000,5269990,5269990,10539980,9989980,18.1636,1984,4
26,1988-08-12,The Last Temptation of Christ,7000000,8373585,8373585,16747170,9747170,1.3924528571428572,1988,8
26,1993-12-22,Philadelphia,26000000,77324422,201324422,278648844,252648844,9.71726323076923,1993,12
26,1998-06-12,The Land Girls,8000000,146083,146083,292166,-7707834,-0.96347925,1998,6
26,1998-10-16,Happiness,3000000,2746453,5746453,8492906,5492906,1.8309686666666667,1998,10
26,2000-07-07,Scary Movie,19000000,157019771,277200000,434219771,415219771,21.85367215789474,2000,7
26,2001-04-06,Just Visiting,40000000,4777007,16172200,20949207,-19050793,-0.476269825,2001,4
26,2001-08-13,K-PAX,48000000,50315140,50315140,100630280,52630280,1.0964641666666666,2001,8
26,2002-05-10,Hybrid,200000,162605,162605,325210,125210,0.62605,2002,5
26,2002-06-14,Scooby-Doo,84000000,153294164,276294164,429588328,345588328,4.114146761904762,2002,6
26,2002-07-25,Austin Powers in Goldmember,63000000,213117789,296338663,509456452,446456452,7.0866103492063495,2002,7
26,2002-08-23,Serving Sara,29000000,16930185,20146150,37076335,8076335,0.2784943103448276,2002,8
26,2003-10-03,Wonderland,5500000,1060512,1060512,2121024,-3378976,-0.6143592727272728,2003,10
26,2003-12-17,The Lord of the Rings: The Return of the King,94000000,377845905,1141403341,1519249246,1425249246,15.162226021276595,2003,12
26,2004-10-15,Shall We Dance?,40000000,57887882,118097882,175985764,135985764,3.3996441,2004,10
26,2005-08-12,Deuce Bigalow: European Gigolo,22000000,22400154,45273464,67673618,45673618,2.0760735454545456,2005,8
26,2005-12-25,Rumor Has It,70000000,42996140,88933562,131929702,61929702,0.8847100285714286,2005,12
26,2005-12-30,The Matador,10000000,12589255,17300838,29890093,19890093,1.9890093,2005,12
26,2006-01-20,Transamerica,1000000,9015303,16553163,25568466,24568466,24.568466,2006,1
26,2006-08-11,Zoom,35000000,11989328,12506188,24495516,-10504484,-0.3001281142857143,2006,8
26,2007-01-26,Blood and Chocolate,15000000,3526588,6551310,10077898,-4922102,-0.3281401333333333,2007,1
26,2007-08-24,Mr. Beanâs Holiday,25000000,33302167,234981342,268283509,243283509,9.73134036,2007,8
26,2008-09-26,The Lucky Ones,14000000,266967,266967,533934,-13466066,-0.9618618571428571,2008,9
26,2008-10-24,Changeling,55000000,35739802,113805580,149545382,94545382,1.7190069454545454,2008,10
26,2008-11-14,Quantum of Solace,230000000,169368427,591692078,761060505,531060505,2.308958717391304,2008,11
26,2009-04-17,Crank 2: High Voltage,20000000,13684249,35472739,49156988,29156988,1.4578494,2009,4
26,2009-08-28,The Open Road,10000000,19716,19716,39432,-9960568,-0.9960568,2009,8
26,2009-11-20,The Blind Side,35000000,255959475,305705794,561665269,526665269,15.047579114285714,2009,11
26,2011-04-22,POM Wonderful Presents: The Greatest Movie Ever Sold,1800000,638476,783733,1422209,-377791,-0.2098838888888889,2011,4
26,2012-04-06,American Reunion,50000000,56758835,236799211,293558046,243558046,4.87116092,2012,4
26,2012-08-17,Robot & Frank,2500000,3317468,4934356,8251824,5751824,2.3007296,2012,8
26,2013-02-22,Snitch,15000000,42930462,57907734,100838196,85838196,5.7225464,2013,2
26,2013-03-22,The Croods,135000000,187168425,573068425,760236850,625236850,4.631384074074074,2013,3
26,2013-08-21,The Mortal Instruments: City of Bones,60000000,31165421,75965567,107130988,47130988,0.7855164666666666,2013,8
26,2013-10-18,Carrie,30000000,35266619,82409520,117676139,87676139,2.922537966666667,2013,10
26,2014-03-07,300: Rise of an Empire,110000000,106580051,330780051,437360102,327360102,2.9760009272727275,2014,3
26,2014-06-13,The Signal,4000000,600896,2665322,3266218,-733782,-0.1834455,2014,6
26,2016-05-27,Alice Through the Looking Glass,170000000,77042381,276928112,353970493,183970493,1.0821793705882352,2016,5
26,2016-07-08,The Secret Life of Pets,75000000,368384330,886750534,1255134864,1180134864,15.73513152,2016,7
26,2017-01-20,The Resurrection of Gavin Stone,2000000,2303792,2303792,4607584,2607584,1.303792,2017,1
27,1968-04-02,2001: A Space Odyssey,10500000,59936321,71928046,131864367,121364367,11.558511142857142,1968,4
27,1970-01-01,Beyond the Valley of the Dolls,1000000,9000000,9000000,18000000,17000000,17.0,1970,1
27,1978-12-22,Force 10 from Navarone,5000000,7100000,7100000,14200000,9200000,1.84,1978,12
27,1979-05-25,The Prisoner of Zenda,12500000,7000000,7000000,14000000,1500000,0.12,1979,5
27,1982-08-13,Fast Times at Ridgemont High,4500000,27092880,27092880,54185760,49685760,11.04128,1982,8
27,1986-09-26,Crocodile Dundee,8800000,174803506,328203506,503007012,494207012,56.159887727272725,1986,9
27,1989-06-02,Dead Poets Society,16400000,95860116,239500000,335360116,318960116,19.44878756097561,1989,6
27,1989-06-23,Batman,35000000,251188924,411348924,662537848,627537848,17.9296528,1989,6
27,1994-09-30,Ed Wood,18000000,5828466,5828466,11656932,-6343068,-0.3523926666666667,1994,9
27,1996-07-02,Independence Day,75000000,306169255,817400878,1123570133,1048570133,13.980935106666667,1996,7
27,1997-03-14,Love Jones,10000000,12554569,12554569,25109138,15109138,1.5109138,1997,3
27,1998-07-31,Ever After: A Cinderella Story,26000000,65705772,65705772,131411544,105411544,4.0542901538461535,1998,7
27,1998-11-06,The Siege,70000000,40934175,116625798,157559973,87559973,1.250856757142857,1998,11
27,1999-03-19,Ravenous,12000000,2062406,2062406,4124812,-7875188,-0.6562656666666666,1999,3
27,1999-05-21,Trekkies,375000,617172,617172,1234344,859344,2.291584,1999,5
27,1999-07-16,The Wood,6000000,25059640,25059640,50119280,44119280,7.353213333333334,1999,7
27,2000-07-28,Nutty Professor II: The Klumps,84000000,123307945,166307945,289615890,205615890,2.4478082142857143,2000,7
27,2000-11-03,The Legend of Bagger Vance,60000000,30695227,39235486,69930713,9930713,0.16551188333333333,2000,11
27,2001-12-25,The Shipping News,35000000,11405825,24405825,35811650,811650,0.02319,2001,12
27,2001-12-25,Kate and Leopold,48000000,47095453,70937778,118033231,70033231,1.4590256458333333,2001,12
27,2002-12-18,The Lord of the Rings: The Two Towers,94000000,342548984,934699645,1277248629,1183248629,12.587751372340426,2002,12
27,2002-12-31,Confessions of a Dangerous Mind,29000000,16007718,33013805,49021523,20021523,0.6903973448275862,2002,12
27,2003-02-28,Poolhall Junkies,4000000,563711,563711,1127422,-2872578,-0.7181445,2003,2
27,2003-04-04,DysFunkTional Family,3000000,2255000,2255000,4510000,1510000,0.5033333333333333,2003,4
27,2003-05-02,The Lizzie McGuire Movie,15000000,42734455,55534455,98268910,83268910,5.551260666666667,2003,5
27,2003-10-03,Sur Le Seuil,2500000,2013052,2013052,4026104,1526104,0.6104416,2003,10
27,2004-12-17,The Aviator,110000000,102608827,208370892,310979719,200979719,1.8270883545454546,2004,12
27,2005-01-07,Travellers and Magicians,1800000,506793,1322161,1828954,28954,0.016085555555555554,2005,1
27,2005-07-01,De battre mon coeur s'est arrÃªtÃ©,5500000,1023424,8589831,9613255,4113255,0.7478645454545455,2005,7
27,2006-02-17,Date Movie,20000000,48548426,85146165,133694591,113694591,5.68472955,2006,2
27,2006-04-07,Take the Lead,30000000,34742066,65390493,100132559,70132559,2.3377519666666666,2006,4
27,2006-08-25,Invincible,40000000,57806952,58501127,116308079,76308079,1.907701975,2006,8
27,2007-05-18,The Wendell Baker Story,8000000,127188,127188,254376,-7745624,-0.968203,2007,5
27,2007-06-01,And Then Came Love,989000,8158,8158,16316,-972684,-0.9835025278058646,2007,6
27,2008-06-13,Baghead,200000,140016,140016,280032,80032,0.40016,2008,6
27,2008-12-25,Waltz with Bashir,2000000,2283849,13912289,16196138,14196138,7.098069,2008,12
27,2010-05-21,Shrek Forever After,165000000,238736787,756244673,994981460,829981460,5.030190666666667,2010,5
27,2010-06-18,Cyrus,7000000,7468936,10062896,17531832,10531832,1.5045474285714286,2010,6
27,2010-09-22,You Will Meet a Tall Dark Stranger,15000000,3247816,34247816,37495632,22495632,1.4997088,2010,9
27,2011-04-01,Hop,63000000,108085305,188657593,296742898,233742898,3.71020473015873,2011,4
27,2011-06-24,Bad Teacher,19000000,100292856,215448997,315741853,296741853,15.617992263157895,2011,6
27,2011-09-30,Margaret,14000000,47185,623292,670477,-13329523,-0.9521087857142857,2011,9
27,2012-05-04,The Avengers,225000000,623279547,1517935897,2141215444,1916215444,8.516513084444444,2012,5
27,2012-07-27,The Watch,55000000,34353000,67130045,101483045,46483045,0.8451462727272727,2012,7
27,2012-10-12,Argo,44500000,136025503,227140757,363166260,318666260,7.161039550561798,2012,10
27,2013-01-25,Hansel & Gretel: Witch Hunters,50000000,55703475,214949716,270653191,220653191,4.41306382,2013,1
27,2014-03-07,The Grand Budapest Hotel,31000000,59076019,163981261,223057280,192057280,6.195396129032258,2014,3
27,2014-06-27,Snowpiercer,40000000,4563029,88069880,92632909,52632909,1.315822725,2014,6
27,2014-09-12,Faith Connections,550000,9111,9111,18222,-531778,-0.9668690909090909,2014,9
27,2015-07-10,Strangerland,10000000,17472,161097,178569,-9821431,-0.9821431,2015,7
27,2015-10-30,Burnt,20000000,13651946,36773510,50425456,30425456,1.5212728,2015,10
27,2015-12-25,The Revenant,135000000,183637894,532938302,716576196,581576196,4.307971822222222,2015,12
27,2016-04-29,Motherâs Day,25000000,32492859,52367022,84859881,59859881,2.39439524,2016,4
27,2017-05-19,Diary of a Wimpy Kid: The Long Haul,22000000,20738724,35609577,56348301,34348301,1.561286409090909,2017,5
28,1956-11-15,Love Me Tender,1000000,9000000,9000000,18000000,17000000,17.0,1956,11
28,1980-01-01,Maniac,350000,10000000,10000000,20000000,19650000,56.142857142857146,1980,1
28,1990-08-10,Flatliners,26000000,61308153,61308153,122616306,96616306,3.7160117692307693,1990,8
28,1993-01-01,Ed and his Dead Mother,1800000,673,673,1346,-1798654,-0.9992522222222222,1993,1
28,1993-08-06,The Fugitive,44000000,183875760,353715317,537591077,493591077,11.217979022727272,1993,8
28,1994-12-16,Dumb & Dumber,16000000,127175374,246400000,373575374,357575374,22.348460875,1994,12
28,1995-08-16,The Usual Suspects,6000000,23341568,34449356,57790924,51790924,8.631820666666666,1995,8
28,1996-09-28,Secrets & Lies,4500000,13417292,13417292,26834584,22334584,4.963240888888889,1996,9
28,1998-10-16,Bride of Chucky,25000000,32404188,50692188,83096376,58096376,2.32385504,1998,10
28,1999-05-28,The Loss of Sexual Innocence,4000000,399793,399793,799586,-3200414,-0.8001035,1999,5
28,1999-06-10,Austin Powers: The Spy Who Shagged Me,35000000,206040085,312383487,518423572,483423572,13.812102057142857,1999,6
28,1999-09-01,Outside Providence,7000000,7309628,7824358,15133986,8133986,1.161998,1999,9
28,1999-11-19,The World is Not Enough,135000000,126930660,361730660,488661320,353661320,2.6197134814814813,1999,11
28,2000-06-16,Jesus' Son,2500000,1282084,1687548,2969632,469632,0.1878528,2000,6
28,2000-10-20,Bedazzled,48000000,37879996,90376224,128256220,80256220,1.6720045833333332,2000,10
28,2000-10-27,George Washington,42000,241816,342722,584538,542538,12.917571428571428,2000,10
28,2000-12-19,The Gift,10000000,12008642,44567606,56576248,46576248,4.6576248,2000,12
28,2001-04-27,The Forsaken,5000000,6755271,6755271,13510542,8510542,1.7021084,2001,4
28,2001-06-15,Lara Croft: Tomb Raider,94000000,131144183,273330185,404474368,310474368,3.3029188085106385,2001,6
28,2002-02-15,Peter Pan: Return to Neverland,20000000,48430258,109862682,158292940,138292940,6.914647,2002,2
28,2002-02-22,Dragonfly,60000000,30063805,30063805,60127610,127610,0.0021268333333333334,2002,2
28,2002-06-14,The Dangerous Lives of Altar Boys,12000000,1779284,1779284,3558568,-8441432,-0.7034526666666666,2002,6
28,2003-03-14,The Hunted,55000000,34234008,47213095,81447103,26447103,0.4808564181818182,2003,3
28,2004-04-30,Envy,20000000,13548322,14566246,28114568,8114568,0.4057284,2004,4
28,2004-09-10,Malevolence,200000,126021,346106,472127,272127,1.360635,2004,9
28,2006-04-14,Hard Candy,950000,1024640,8267066,9291706,8341706,8.780743157894737,2006,4
28,2006-06-28,Strangers with Candy,2000000,2072645,2077844,4150489,2150489,1.0752445,2006,6
28,2006-07-07,Pirates of the Caribbean: Dead Manâs Chest,225000000,423315812,1066215812,1489531624,1264531624,5.6201405511111115,2006,7
28,2007-04-20,In the Land of Women,10500000,11052958,14140402,25193360,14693360,1.399367619047619,2007,4
28,2007-07-20,Sunshine,40000000,3688560,32030610,35719170,-4280830,-0.10702075,2007,7
28,2007-08-10,Stardust,70000000,38634938,137022245,175657183,105657183,1.5093883285714285,2007,8
28,2008-01-18,Mad Money,22000000,20668843,25044057,45712900,23712900,1.0778590909090908,2008,1
28,2008-06-06,Mongol,18000000,5705761,27147349,32853110,14853110,0.8251727777777778,2008,6
28,2009-08-26,Taking Woodstock,29000000,7460204,10066366,17526570,-11473430,-0.3956355172413793,2009,8
28,2009-12-18,The Young Victoria,35000000,11001272,31878891,42880163,7880163,0.22514751428571428,2009,12
28,2010-10-15,Conviction,12500000,6797696,11826980,18624676,6124676,0.48997408,2010,10
28,2010-10-29,Wild Target,8000000,109338,5314194,5423532,-2576468,-0.3220585,2010,10
28,2011-02-18,I am Number Four,50000000,55100437,146195159,201295596,151295596,3.02591192,2011,2
28,2011-04-01,Haevnen,5500000,1008098,15867314,16875412,11375412,2.0682567272727272,2011,4
28,2013-02-15,Escape From Planet Earth,40000000,57012977,74156610,131169587,91169587,2.279239675,2013,2
28,2013-07-19,RED 2,84000000,53262560,141507355,194769915,110769915,1.3186894642857143,2013,7
28,2014-09-19,Tusk,3000000,1821983,1887554,3709537,709537,0.23651233333333332,2014,9
28,2015-03-13,Hross i oss,10000000,11894,11894,23788,-9976212,-0.9976212,2015,3
28,2015-07-29,Vacation,31000000,58884188,102306500,161190688,130190688,4.199699612903226,2015,7
28,2015-10-23,Rock the Kasbah,15000000,3020665,3386153,6406818,-8593182,-0.5728788,2015,10
28,2015-12-04,Krampus,15000000,42725475,61788393,104513868,89513868,5.9675912,2015,12
28,2016-08-12,Sausage Party,19000000,97670358,141344255,239014613,220014613,11.579716473684211,2016,8
28,2016-11-04,Doctor Strange,165000000,232641920,676404566,909046486,744046486,4.509372642424243,2016,11
28,2016-12-21,Passengers,110000000,100014699,302239672,402254371,292254371,2.656857918181818,2016,12
28,2017-09-15,American Assassin,63000000,36249674,68310140,104559814,41559814,0.6596795873015873,2017,9
28,2018-03-02,Death Wish,30000000,34017028,48575965,82592993,52592993,1.7530997666666666,2018,3
28,2018-11-09,Dr. Seussâ The Grinch,75000000,270620950,511002426,781623376,706623376,9.421645013333332,2018,11
29,1985-05-22,Rambo: First Blood Part II,44000000,150415432,300400000,450815432,406815432,9.245805272727273,1985,5
29,1987-01-01,American Ninja 2: The Confrontation,350000,4000000,4000000,8000000,7650000,21.857142857142858,1987,1
29,1987-11-06,Cry Freedom,29000000,5899797,25899797,31799594,2799594,0.09653772413793103,1987,11
29,1989-07-14,When Harry Met Sallyâ¦,16000000,92823546,92961960,185785506,169785506,10.611594125,1989,7
29,1989-08-11,A Nightmare On Elm Street: The Dream Child,6000000,22168359,22168359,44336718,38336718,6.389453,1989,8
29,1989-09-15,Sea of Love,19000000,58571513,58571513,117143026,98143026,5.165422421052631,1989,9
29,1990-07-18,Arachnophobia,31000000,53208180,53208180,106416360,75416360,2.432785806451613,1990,7
29,1992-03-01,Night on Earth,2000000,2015000,2022893,4037893,2037893,1.0189465,1992,3
29,1994-03-11,The Hudsucker Proxy,40000000,2816518,14938149,17754667,-22245333,-0.556133325,1994,3
29,1994-06-24,Wyatt Earp,63000000,25052000,25052000,50104000,-12896000,-0.20469841269841269,1994,6
29,1994-12-31,There Goes My Baby,10500000,125169,125169,250338,-10249662,-0.9761582857142858,1994,12
29,1998-06-26,Out of Sight,48000000,37562568,77562568,115125136,67125136,1.3984403333333333,1998,6
29,1998-07-10,Small Soldiers,40000000,55143823,71743823,126887646,86887646,2.17219115,1998,7
29,1999-06-04,Instinct,55000000,34105207,34105207,68210414,13210414,0.24018934545454546,1999,6
29,2001-09-28,Donât Say a Word,50000000,54997476,104488383,159485859,109485859,2.18971718,2001,9
29,2002-09-27,Charly,950000,814666,814666,1629332,679332,0.7150863157894737,2002,9
29,2002-12-19,25th Hour,4500000,13084595,25344490,38429085,33929085,7.539796666666667,2002,12
29,2003-02-14,The Jungle Book 2,20000000,47901582,140122225,188023807,168023807,8.40119035,2003,2
29,2003-08-15,Open Range,26000000,58331254,68613992,126945246,100945246,3.8825094615384614,2003,8
29,2005-02-11,Bride & Prejudice,7000000,6601079,25269040,31870119,24870119,3.5528741428571426,2005,2
29,2005-05-27,Saving Face,2500000,1187266,1269705,2456971,-43029,-0.0172116,2005,5
29,2005-09-09,Side Effects,200000,44701,44701,89402,-110598,-0.55299,2005,9
29,2006-01-20,End of the Spear,10000000,11748661,11924041,23672702,13672702,1.3672702,2006,1
29,2006-06-23,Click,82500000,137355633,237685089,375040722,292540722,3.5459481454545454,2006,6
29,2006-10-13,One Night with the King,20000000,13395961,13725032,27120993,7120993,0.35604965,2006,10
29,2007-10-12,Lars and the Real Girl,12500000,5956480,11277119,17233599,4733599,0.37868792,2007,10
29,2007-11-30,Awake,8600000,14373825,32968648,47342473,38742473,4.504938720930233,2007,11
29,2008-04-18,Pathology,8000000,109045,3270974,3380019,-4619981,-0.577497625,2008,4
29,2008-09-26,Fireproof,500000,33456317,33473297,66929614,66429614,132.859228,2008,9
29,2008-10-08,RocknRolla,18000000,5700626,27794339,33494965,15494965,0.8608313888888889,2008,10
29,2009-10-16,Janky Promoters,10000000,9069,9069,18138,-9981862,-0.9981862,2009,10
29,2010-09-15,Never Let Me Go,15000000,2434652,11173718,13608370,-1391630,-0.09277533333333333,2010,9
29,2010-11-24,Love and Other Drugs,30000000,32367005,102716321,135083326,105083326,3.5027775333333335,2010,11
29,2010-12-22,True Grit,35000000,171243005,252276928,423519933,388519933,11.100569514285715,2010,12
29,2011-01-14,The Green Hornet,110000000,98780042,229155503,327935545,217935545,1.9812322272727272,2011,1
29,2011-03-04,Rango,135000000,123477607,245724600,369202207,234202207,1.734831162962963,2011,3
29,2011-05-13,Priest,60000000,29136626,84154026,113290652,53290652,0.8881775333333334,2011,5
29,2011-10-21,Le Havre,5500000,611709,13480196,14091905,8591905,1.5621645454545454,2011,10
29,2012-06-15,Rock of Ages,70000000,38518613,61031932,99550545,29550545,0.4221506428571429,2012,6
29,2012-09-21,End of Watch,15000000,41003371,57586606,98589977,83589977,5.5726651333333335,2012,9
29,2013-03-01,Stoker,12000000,1703125,12034913,13738038,1738038,0.1448365,2013,3
29,2013-06-14,Man of Steel,225000000,291045518,667999518,959045036,734045036,3.2624223822222223,2013,6
29,2013-11-27,Homefront,22000000,20158492,51695362,71853854,49853854,2.2660842727272725,2013,11
29,2014-03-07,The Face of Love,4000000,385069,1158877,1543946,-2456054,-0.6140135,2014,3
29,2014-03-28,Sabotage,35000000,10508518,18376443,28884961,-6115039,-0.1747154,2014,3
29,2014-11-07,Big Hero 6,165000000,222527828,652127828,874655656,709655656,4.30094336969697,2014,11
29,2015-02-13,Kingsman: The Secret Service,94000000,128261724,404561724,532823448,438823448,4.66833455319149,2015,2
29,2016-12-21,Sing,75000000,270329045,634454789,904783834,829783834,11.063784453333334,2016,12
29,2017-02-17,Fist Fight,25000000,32187017,40286416,72473433,47473433,1.89893732,2017,2
29,2017-05-12,The Wall,3000000,1803064,4495262,6298326,3298326,1.099442,2017,5
29,2018-07-20,Unfriended: Dark Web,1000000,8866745,16434588,25301333,24301333,24.301333,2018,7
29,2018-09-21,Fahrenheit 11/9,5000000,6352306,6653715,13006021,8006021,1.6012042,2018,9
30,1949-12-14,Sands of Iwo Jima,1000000,7800000,7800000,15600000,14600000,14.6,1949,12
30,1974-11-15,Benji,500000,31559560,31559560,63119120,62619120,125.23824,1974,11
30,1982-06-25,Megaforce,18000000,5675599,5675599,11351198,-6648802,-0.3693778888888889,1982,6
30,1984-12-14,The Cotton Club,48000000,25928721,25928721,51857442,3857442,0.080363375,1984,12
30,1985-09-13,After Hours,4500000,10609321,10609321,21218642,16718642,3.715253777777778,1985,9
30,1989-07-21,UHF,5000000,6157157,6157157,12314314,7314314,1.4628628,1989,7
30,1992-05-15,Lethal Weapon 3,35000000,144731527,319700000,464431527,429431527,12.2694722,1992,5
30,1993-01-29,Nemesis,2000000,2001124,2001124,4002248,2002248,1.001124,1993,1
30,1994-08-03,Clear and Present Danger,62000000,122012656,207500000,329512656,267512656,4.314720258064516,1994,8
30,1994-10-21,Bullets Over Broadway,20000000,13383747,13383747,26767494,6767494,0.3383747,1994,10
30,1996-10-18,Sleepers,44000000,53300852,165600852,218901704,174901704,3.9750387272727274,1996,10
30,1997-07-31,Spawn,40000000,54979992,87949859,142929851,102929851,2.573246275,1997,7
30,1997-10-08,Seven Years in Tibet,70000000,37945884,131445884,169391768,99391768,1.4198824,1997,10
30,1998-09-04,Knock Off,35000000,10319915,10319915,20639830,-14360170,-0.41029057142857145,1998,9
30,1998-12-25,The Faculty,15000000,40283321,40283321,80566642,65566642,4.371109466666667,1998,12
30,1999-03-05,"Lock, Stock and Two Smoking Barrels",1350000,3897569,28356188,32253757,30903757,22.891671851851854,1999,3
30,2000-05-19,Road Trip,16000000,68525609,119739110,188264719,172264719,10.7665449375,2000,5
30,2000-08-25,Smiling Fish and Goat on Fire,40000,277233,277233,554466,514466,12.86165,2000,8
30,2001-03-09,Get Over It,10000000,11560259,19860259,31420518,21420518,2.1420518,2001,3
30,2001-07-18,Jurassic Park III,93000000,181166115,365900000,547066115,454066115,4.882431344086021,2001,7
30,2002-04-05,National Lampoonâs Van Wilder,6000000,21305259,39241323,60546582,54546582,9.091097,2002,4
30,2002-05-17,Harvard Man,5500000,56653,56653,113306,-5386694,-0.9793989090909091,2002,5
30,2002-11-29,Rabbit-Proof Fence,7000000,6199600,16866928,23066528,16066528,2.2952182857142858,2002,11
30,2003-01-10,Just Married,19000000,56127162,101564935,157692097,138692097,7.299584052631579,2003,1
30,2003-10-24,Elephant,3000000,1266955,10051516,11318471,8318471,2.7728236666666666,2003,10
30,2003-11-14,Master and Commander: The Far Side of the World,135000000,93926386,212912137,306838523,171838523,1.2728779481481483,2003,11
30,2003-12-12,Stuck On You,55000000,33832741,63537164,97369905,42369905,0.7703619090909091,2003,12
30,2004-02-20,The Blue Butterfly,10400000,1610194,1610194,3220388,-7179612,-0.6903473076923077,2004,2
30,2005-07-08,Murderball,350000,1531154,1772979,3304133,2954133,8.44038,2005,7
30,2005-08-19,Red Eye,26000000,57891803,96666486,154558289,128558289,4.944549576923077,2005,8
30,2005-12-09,Brokeback Mountain,13900000,83043761,176980863,260024624,246124624,17.706807482014387,2005,12
30,2006-06-16,Garfield: A Tail of Two Kitties,60000000,28426747,147985373,176412120,116412120,1.940202,2006,6
30,2006-12-15,Charlotte's Web,82500000,82985708,143985708,226971416,144471416,1.7511686787878789,2006,12
30,2007-03-16,Premonition,20000000,47852604,81461343,129313947,109313947,5.46569735,2007,3
30,2007-11-21,August Rush,25000000,31664162,65882103,97546265,72546265,2.9018506,2007,11
30,2007-12-21,Blonde Ambition,10000000,6422,1537479,1543901,-8456099,-0.8456099,2007,12
30,2008-03-07,Married Life,12000000,1506998,2975188,4482186,-7517814,-0.6264845,2008,3
30,2008-05-16,The Chronicles of Narnia: Prince Caspian,225000000,141621490,417341288,558962778,333962778,1.4842790133333332,2008,5
30,2008-06-20,Brick Lane,2500000,1094998,3838486,4933484,2433484,0.9733936,2008,6
30,2008-09-19,Igor,22000000,19528602,31013349,50541951,28541951,1.2973614090909091,2008,9
30,2008-10-10,Good Dick,200000,28835,52443,81278,-118722,-0.59361,2008,10
30,2010-03-26,How to Train Your Dragon,165000000,217581232,494870992,712452224,547452224,3.3178922666666666,2010,3
30,2010-05-21,Solitary Man,12500000,4360548,4360548,8721096,-3778904,-0.30231232,2010,5
30,2012-10-05,Wuthering Heights,8000000,100915,2721534,2822449,-5177551,-0.647193875,2012,10
30,2014-04-11,Joe,4000000,373375,373375,746750,-3253250,-0.8133125,2014,4
30,2015-06-03,Entourage,30000000,32363404,46438538,78801942,48801942,1.6267314,2015,6
30,2016-01-15,13 Hours: The Secret Soldiers of Benghazi,50000000,52853219,69411370,122264589,72264589,1.44529178,2016,1
30,2016-09-09,The Disappointments Room,15000000,2423467,3503761,5927228,-9072772,-0.6048514666666667,2016,9
30,2016-09-30,Miss Peregrineâs Home for Peculiar Children,110000000,87242834,295986876,383229710,273229710,2.4839064545454543,2016,9
30,2016-11-11,Billy Lynnâs Long Halftime Walk,40000000,1738477,30230402,31968879,-8031121,-0.200778025,2016,11
30,2016-11-18,Manchester by the Sea,8500000,47695371,77733867,125429238,116929238,13.75638094117647,2016,11
30,2017-06-30,Despicable Me 3,75000000,264624300,1034727750,1299352050,1224352050,16.324694,2017,6
30,2019-02-13,Isnât it Romantic,31000000,48791187,48791187,97582374,66582374,2.1478185161290324,2019,2
31,1946-12-31,Duel in the Sun,6000000,20400000,20400000,40800000,34800000,5.8,1946,12
31,1956-06-27,Moby Dick,4500000,10400000,10400000,20800000,16300000,3.6222222222222222,1956,6
31,1982-12-08,The Verdict,16000000,53977250,53977250,107954500,91954500,5.74715625,1982,12
31,1983-08-19,The Ballad of Gregorio Cortez,1305000,909000,909000,1818000,513000,0.3931034482758621,1983,8
31,1986-07-01,Pirates,40000000,1641825,6341825,7983650,-32016350,-0.80040875,1986,7
31,1988-03-04,Prison,4000000,354704,354704,709408,-3290592,-0.822648,1988,3
31,1993-06-09,What's Love Got to Do With It,15000000,39100956,39100956,78201912,63201912,4.2134608,1993,6
31,1995-07-01,Clueless,13700000,56598476,56598476,113196952,99496952,7.262551240875912,1995,7
31,1997-05-22,The Lost World: Jurassic Park,75000000,229086679,618638999,847725678,772725678,10.30300904,1997,5
31,1998-09-18,Rush Hour,35000000,141186864,245300000,386486864,351486864,10.042481828571429,1998,9
31,1999-09-24,Mumford,28700000,4559569,4559569,9119138,-19580862,-0.68226,1999,9
31,2000-04-21,U-571,62000000,77086030,127630030,204716060,142716060,2.301871935483871,2000,4
31,2000-04-28,Frequency,31000000,44983704,68079671,113063375,82063375,2.64720564516129,2000,4
31,2000-09-22,Dancer in the Dark,12500000,4157491,45557491,49714982,37214982,2.97719856,2000,9
31,2000-10-20,The Legend of Drunken Master,10000000,11546543,11546543,23093086,13093086,1.3093086,2000,10
31,2001-02-09,Saving Silverman,22000000,19351569,25873142,45224711,23224711,1.0556686818181817,2001,2
31,2001-06-01,What's the Worst That Could Happen?,30000000,32267774,38462071,70729845,40729845,1.3576615,2001,6
31,2001-11-02,Le Fabuleux destin d'AmÃ©lie Poulain,10350000,33201661,174201661,207403322,197053322,19.038968309178745,2001,11
31,2002-05-08,Unfaithful,50000000,52752475,119114494,171866969,121866969,2.43733938,2002,5
31,2003-12-25,The Company,15000000,2281585,3396508,5678093,-9321907,-0.6214604666666667,2003,12
31,2004-08-06,Open Water,500000,30500882,55518641,86019523,85519523,171.039046,2004,8
31,2004-08-27,Anacondas: The Hunt for the Blood Orchid,25000000,31526393,70326393,101852786,76852786,3.07411144,2004,8
31,2004-09-17,Sky Captain and the World of Tomorrow,70000000,37760080,49730854,87490934,17490934,0.24987048571428572,2004,9
31,2005-04-29,XXX: State of the Union,60000000,26873932,71073932,97947864,37947864,0.6324644,2005,4
31,2005-08-05,2046,12000000,1442338,19287485,20729823,8729823,0.72748525,2005,8
31,2006-07-21,The Case of the Grinning Cat,200000,7033,7033,14066,-185934,-0.92967,2006,7
31,2006-10-04,Shortbus,2000000,1985292,1985292,3970584,1970584,0.985292,2006,10
31,2007-07-27,Who's Your Caddy?,7000000,5694308,5694308,11388616,4388616,0.6269451428571429,2007,7
31,2008-01-25,Rambo,47500000,42754105,112214531,154968636,107468636,2.2624976,2008,1
31,2008-02-14,Jumper,82500000,80172128,222640812,302812940,220312940,2.6704598787878786,2008,2
31,2008-02-29,Semi-Pro,55000000,33479698,43980363,77460061,22460061,0.40836474545454543,2008,2
31,2008-09-19,Ghost Town,20000000,13367624,29958228,43325852,23325852,1.1662926,2008,9
31,2009-09-11,I Can Do Bad All By Myself,19000000,51733921,51733921,103467842,84467842,4.445675894736842,2009,9
31,2009-09-11,Whiteout,35000000,10275638,12254746,22530384,-12469616,-0.35627474285714283,2009,9
31,2009-12-16,Crazy Heart,8500000,39471742,47417251,86888993,78388993,9.222234470588235,2009,12
31,2010-03-12,The Exploding Girl,40000,25572,25572,51144,11144,0.2786,2010,3
31,2010-05-28,Sea Rex 3D: Journey to a Prehistoric World,5000000,6096582,16515203,22611785,17611785,3.522357,2010,5
31,2010-07-30,Charlie St. Cloud,44000000,31206263,48478084,79684347,35684347,0.8110078863636364,2010,7
31,2010-08-06,The Oxford Murders,10000000,4803,17704131,17708934,7708934,0.7708934,2010,8
31,2010-08-20,Mao's Last Dancer,18000000,4806750,25941437,30748187,12748187,0.7082326111111111,2010,8
31,2010-09-01,My Dog Tulip,350000,246574,310891,557465,207465,0.5927571428571429,2010,9
31,2011-07-15,Salvation Boulevard,5500000,28468,28468,56936,-5443064,-0.989648,2011,7
31,2011-08-05,Rise of the Planet of the Apes,93000000,176760185,470986200,647746385,554746385,5.965014892473119,2011,8
31,2011-10-07,Real Steel,110000000,85463309,263880341,349343650,239343650,2.1758513636363634,2011,10
31,2011-12-09,New Yearâs Eve,26000000,54544638,146850273,201394911,175394911,6.7459581153846155,2011,12
31,2012-04-06,Damsels in Distress,3000000,1007535,1324299,2331834,-668166,-0.222722,2012,4
31,2012-07-03,The Amazing Spider-Man,220000000,262030663,757890267,1019920930,799920930,3.636004227272727,2012,7
31,2012-11-02,Wreck-It Ralph,165000000,189412677,496511521,685924198,520924198,3.1571163515151515,2012,11
31,2012-11-09,Dangerous Liaisons,24200000,17000,10447579,10464579,-13735421,-0.5675793801652893,2012,11
31,2013-03-01,The Lost Medallion: The Adventures of Billy Stone,2500000,549632,549632,1099264,-1400736,-0.5602944,2013,3
31,2013-07-17,Turbo,135000000,83028130,286896578,369924708,234924708,1.7401830222222223,2013,7
31,2014-11-26,Horrible Bosses 2,40000000,54445357,105945357,160390714,120390714,3.00976785,2014,11
31,2015-09-25,The Green Inferno,1000000,7192291,12931420,20123711,19123711,19.123711,2015,9
31,2016-11-18,A Street Cat Named Bob,8000000,82703,17382693,17465396,9465396,1.1831745,2016,11
31,2017-10-20,Tyler Perryâs Boo 2! A Madea Halloween,20000000,47319572,47879572,95199144,75199144,3.7599572,2017,10
32,1936-06-26,San Francisco,1300000,2868000,5273000,8141000,6841000,5.262307692307692,1936,6
32,1977-01-01,Kingdom of the Spiders,500000,17000000,17000000,34000000,33500000,67.0,1977,1
32,1977-06-15,A Bridge Too Far,26000000,50800000,50800000,101600000,75600000,2.9076923076923076,1977,6
32,1986-11-26,Star Trek IV: The Voyage Home,24000000,109713132,133000000,242713132,218713132,9.113047166666666,1986,11
32,1992-05-01,Split Second,7000000,5430822,5430822,10861644,3861644,0.5516634285714286,1992,5
32,1995-11-17,The American President,62000000,60022813,107822813,167845626,105845626,1.7071875161290322,1995,11
32,1996-02-02,The Juror,44000000,22730924,22730924,45461848,1461848,0.03322381818181818,1996,2
32,1996-12-25,Hamlet,18000000,4501094,7129670,11630764,-6369236,-0.35384644444444446,1996,12
32,1997-08-15,Event Horizon,60000000,26673242,26673242,53346484,-6653516,-0.11089193333333333,1997,8
32,1998-05-01,Shooting Fish,4000000,302204,302204,604408,-3395592,-0.848898,1998,5
32,1999-01-15,Varsity Blues,16000000,52894169,54294169,107188338,91188338,5.699271125,1999,1
32,1999-02-19,Office Space,10000000,10827813,12179708,23007521,13007521,1.3007521,1999,2
32,1999-07-02,Summer of Sam,22000000,19288130,19288130,38576260,16576260,0.7534663636363637,1999,7
32,2000-09-27,Best in Show,6000000,18621249,20695413,39316662,33316662,5.552777,2000,9
32,2001-09-28,Hearts in Atlantis,31000000,24185781,30885781,55071562,24071562,0.776502,2001,9
32,2001-12-14,Not Another Teen Movie,15000000,37882551,62401343,100283894,85283894,5.685592933333333,2001,12
32,2002-01-25,The Count of Monte Cristo,40000000,54228104,75389090,129617194,89617194,2.24042985,2002,1
32,2002-11-22,The Quiet American,20000000,12987647,26348203,39335850,19335850,0.9667925,2002,11
32,2003-09-26,My Life Without Me,2500000,432360,12267275,12699635,10199635,4.079854,2003,9
32,2004-07-16,A Cinderella Story,19000000,51438175,70164105,121602280,102602280,5.40012,2004,7
32,2005-01-07,Solitude,200000,6260,6260,12520,-187480,-0.9374,2005,1
32,2005-02-04,Boogeyman,20000000,46752382,67192859,113945241,93945241,4.69726205,2005,2
32,2005-03-04,The Jacket,28500000,6301131,15452978,21754109,-6745891,-0.2366979298245614,2005,3
32,2005-03-25,Oldboy,3000000,707391,6239723,6947114,3947114,1.3157046666666667,2005,3
32,2006-01-06,Grandmaâs Boy,5000000,6090172,6590172,12680344,7680344,1.5360688,2006,1
32,2006-03-31,Ice Age: The Meltdown,75000000,195330621,651899282,847229903,772229903,10.296398706666666,2006,3
32,2006-08-18,10th & Wolf,8000000,54702,143782,198484,-7801516,-0.9751895,2006,8
32,2006-10-18,51 Birch Street,350000,84689,84689,169378,-180622,-0.5160628571428572,2006,10
32,2007-09-14,The Brave One,70000000,36793804,69792704,106586508,36586508,0.5226644,2007,9
32,2008-02-14,The Spiderwick Chronicles,92500000,71195053,162839667,234034720,141534720,1.530105081081081,2008,2
32,2008-05-02,Son of Rambow: A Home Movie,2000000,1785505,11263263,13048768,11048768,5.524384,2008,5
32,2008-07-11,Hellboy II: The Golden Army,82500000,75986503,160388063,236374566,153874566,1.8651462545454545,2008,7
32,2008-07-18,Transsiberian,15000000,2203641,6379575,8583216,-6416784,-0.4277856,2008,7
32,2008-08-15,Star Wars: The Clone Wars,8500000,35161554,68695443,103856997,95356997,11.218470235294118,2008,8
32,2008-12-12,Delgo,40000000,915840,915840,1831680,-38168320,-0.954208,2008,12
32,2010-06-11,The A-Team,110000000,77222099,177241171,254463270,144463270,1.3133024545454546,2010,6
32,2010-12-17,Casino Jack,12500000,2039869,2272186,4312055,-8187945,-0.6550356,2010,12
32,2011-02-11,Raymond Did It,40000,3632,3632,7264,-32736,-0.8184,2011,2
32,2011-03-11,Kill the Irishman,12000000,1188194,1188194,2376388,-9623612,-0.8019676666666666,2011,3
32,2011-12-09,The Sitter,25000000,30542576,38749404,69291980,44291980,1.7716792,2011,12
32,2012-05-18,Battleship,220000000,65233400,313477717,378711117,158711117,0.7214141681818181,2012,5
32,2013-02-08,Side Effects,30000000,32172757,66742138,98914895,68914895,2.2971631666666665,2013,2
32,2013-02-08,Identity Thief,35000000,134506920,175361578,309868498,274868498,7.853385657142857,2013,2
32,2014-11-05,Interstellar,165000000,188017894,666379375,854397269,689397269,4.178165266666666,2014,11
32,2014-12-26,Barbecue,10000000,388,247565,247953,-9752047,-0.9752047,2014,12
32,2015-01-23,R100,5500000,24956,24956,49912,-5450088,-0.9909250909090909,2015,1
32,2015-03-06,Unfinished Business,35000000,10219501,13214051,23433552,-11566448,-0.3304699428571429,2015,3
32,2016-03-25,The Lobster,4500000,9196278,18019834,27216112,22716112,5.048024888888889,2016,3
32,2016-06-03,Teenage Mutant Ninja Turtles: Out of the Shadows,135000000,82051601,245328374,327379975,192379975,1.425036851851852,2016,6
32,2016-07-13,The Infiltrator,47500000,15436808,20718104,36154912,-11345088,-0.23884395789473684,2016,7
32,2017-02-03,I Am Not Your Negro,1000000,7123919,9617402,16741321,15741321,15.741321,2017,2
32,2017-09-29,American Made,50000000,51342000,135569212,186911212,136911212,2.73822424,2017,9
32,2018-02-23,Annihilation,55000000,32732301,43070915,75803216,20803216,0.3782402909090909,2018,2
33,1980-05-23,The Shining,19000000,44017374,44728227,88745601,69745601,3.670821105263158,1980,5
33,1983-02-18,Lovesick,10100000,10143618,10143618,20287236,10187236,1.0086372277227722,1983,2
33,1990-03-30,Teenage Mutant Ninja Turtles,13500000,135265915,202000000,337265915,323765915,23.982660370370372,1990,3
33,1990-06-15,Dick Tracy,47000000,103738726,162738726,266477452,219477452,4.6697330212765955,1990,6
33,1991-03-08,Nikita,7000000,5017971,5017971,10035942,3035942,0.433706,1991,3
33,1992-11-11,Aladdin,28000000,217350219,504050219,721400438,693400438,24.764301357142855,1992,11
33,1996-10-04,Bound,4500000,3802260,7011317,10813577,6313577,1.4030171111111112,1996,10
33,1997-12-12,Scream 2,24000000,101363301,172363301,273726602,249726602,10.405275083333333,1997,12
33,1997-12-31,Oscar and Lucinda,12500000,1612957,1612957,3225914,-9274086,-0.74192688,1997,12
33,1998-08-14,Slums of Beverly Hills,5000000,5502773,5502773,11005546,6005546,1.2011092,1998,8
33,1998-10-09,Festen,1300000,1647780,1647780,3295560,1995560,1.535046153846154,1998,10
33,1998-11-06,Elizabeth,25000000,30082699,82150642,112233341,87233341,3.48933364,1998,11
33,1999-07-23,Drop Dead Gorgeous,10000000,10571408,10571408,21142816,11142816,1.1142816,1999,7
33,1999-10-22,Crazy in Alabama,15000000,1954202,1954202,3908404,-11091596,-0.7394397333333333,1999,10
33,2000-02-11,The Tigger Movie,20000000,45542421,96147688,141690109,121690109,6.08450545,2000,2
33,2001-09-14,The Glass House,22000000,17951431,22861785,40813216,18813216,0.8551461818181818,2001,9
33,2002-11-01,I Spy,70000000,33561137,60279822,93840959,23840959,0.3405851285714286,2002,11
33,2002-11-15,Revolution#9,350000,9118,9118,18236,-331764,-0.9478971428571429,2002,11
33,2003-07-02,Sinbad: Legend of the Seven Seas,60000000,26483452,80767884,107251336,47251336,0.7875222666666667,2003,7
33,2003-09-12,"The Book of Mormon Movie, Volume 1: The Journey",2000000,1660865,1660865,3321730,1321730,0.660865,2003,9
33,2004-11-05,The Incredibles,92000000,261441092,614726752,876167844,784167844,8.523563521739131,2004,11
33,2005-05-13,Mad Hot Ballroom,500000,8117961,9387581,17505542,17005542,34.011084,2005,5
33,2005-05-27,Madagascar,75000000,193595521,556559566,750155087,675155087,9.002067826666666,2005,5
33,2005-05-27,The Longest Yard,82000000,158119460,191558505,349677965,267677965,3.264365426829268,2005,5
33,2005-09-30,Duma,12000000,870067,994790,1864857,-10135143,-0.84459525,2005,9
33,2005-11-23,Syriana,50000000,50824620,92690959,143515579,93515579,1.87031158,2005,11
33,2006-03-31,Marilyn Hotchkiss' Ballroom Dancing and Charm School,2500000,349132,497195,846327,-1653673,-0.6614692,2006,3
33,2006-06-30,The Devil Wears Prada,35000000,124740460,326073155,450813615,415813615,11.880389,2006,6
33,2006-10-20,The Prestige,40000000,53089891,104407366,157497257,117497257,2.937431425,2006,10
33,2007-09-07,The Hunting Party,40000000,876671,7729552,8606223,-31393777,-0.784844425,2007,9
33,2009-05-08,Adoration,4000000,294244,384244,678488,-3321512,-0.830378,2009,5
33,2009-09-09,9,30000000,31749894,48559999,80309893,50309893,1.6769964333333334,2009,9
33,2010-01-22,Extraordinary Measures,31000000,12482741,15826984,28309725,-2690275,-0.08678306451612904,2010,1
33,2011-05-06,Hobo with a Shotgun,3000000,703372,834953,1538325,-1461675,-0.487225,2011,5
33,2011-11-18,Happy Feet Two,135000000,64006466,157956466,221962932,86962932,0.6441698666666666,2011,11
33,2012-05-25,Moonrise Kingdom,16000000,45512466,68848446,114360912,98360912,6.147557,2012,5
33,2012-10-19,The Sessions,1000000,6002451,11495204,17497655,16497655,16.497655,2012,10
33,2013-04-26,Pain & Gain,26000000,49875291,81275291,131150582,105150582,4.044253153846154,2013,4
33,2013-05-17,Jagten,3450000,687185,18309793,18996978,15546978,4.506370434782609,2013,5
33,2013-07-31,The Smurfs 2,110000000,71017784,348547523,419565307,309565307,2.8142300636363635,2013,7
33,2014-02-06,The Interview,44000000,6105175,12342632,18447807,-25552193,-0.5807316590909091,2014,2
33,2014-03-14,The Word,200000,3648,3648,7296,-192704,-0.96352,2014,3
33,2014-04-11,The Railway Man,18000000,4438438,23910210,28348648,10348648,0.5749248888888889,2014,4
33,2014-12-03,Wild,15000000,37880356,52460543,90340899,75340899,5.0227266,2014,12
33,2015-02-20,The DUFF,8500000,34030343,43528634,77558977,69058977,8.124585529411764,2015,2
33,2015-05-22,Aloft,8000000,53086,237688,290774,-7709226,-0.96365325,2015,5
33,2015-09-30,The Walk,35000000,10161183,61492104,71653287,36653287,1.0472367714285715,2015,9
33,2015-10-16,Crimson Peak,55000000,31090320,74966854,106057174,51057174,0.9283122545454545,2015,10
33,2015-12-25,The Hateful Eight,62000000,54117416,147864886,201982302,139982302,2.257779064516129,2015,12
33,2016-02-26,Triple 9,20000000,12639297,25943792,38583089,18583089,0.92915445,2016,2
33,2016-06-24,Independence Day: Resurgence,165000000,103144286,384169424,487313710,322313710,1.9534164242424243,2016,6
33,2017-06-21,Transformers: The Last Knight,217000000,130168683,602893340,733062023,516062023,2.378166004608295,2017,6
33,2019-03-29,Unplanned,6000000,18107621,18107621,36215242,30215242,5.035873666666666,2019,3
34,1956-10-05,The Ten Commandments,13500000,85400591,85434516,170835107,157335107,11.65445237037037,1956,10
34,1962-12-16,Lawrence of Arabia,15000000,37495385,69995385,107490770,92490770,6.166051333333334,1962,12
34,1969-05-28,Once Upon a Time in the West,5000000,5321508,5378425,10699933,5699933,1.1399866,1969,5
34,1970-09-23,"Tora, Tora, Tora",25000000,29548291,29548291,59096582,34096582,1.36386328,1970,9
34,1980-11-19,Heaven's Gate,44000000,3484331,3484523,6968854,-37031146,-0.8416169545454546,1980,11
34,1984-05-23,Indiana Jones and the Temple of Doom,28000000,179880271,333080271,512960542,484960542,17.320019357142858,1984,5
34,1986-01-17,The Clan of the Cave Bear,15000000,1953732,1953732,3907464,-11092536,-0.7395024,1986,1
34,1991-07-01,The Last Waltz,35000,321952,322563,644515,609515,17.414714285714286,1991,7
34,1995-12-29,Restoration,18000000,4100000,4100000,8200000,-9800000,-0.5444444444444444,1995,12
34,1996-10-11,Trees Lounge,1300000,749741,749741,1499482,199482,0.1534476923076923,1996,10
34,1996-11-01,The Funeral,12500000,1212799,1412799,2625598,-9874402,-0.78995216,1996,11
34,2000-05-12,Hamlet,2000000,1577287,2419669,3996956,1996956,0.998478,2000,5
34,2000-08-04,Psycho Beach Party,4000000,267972,267972,535944,-3464056,-0.866014,2000,8
34,2000-10-06,Requiem for a Dream,4500000,3635482,7389233,11024715,6524715,1.4499366666666667,2000,10
34,2001-10-26,Thirteen Ghosts,19000000,41867960,68467960,110335920,91335920,4.807153684210526,2001,10
34,2001-12-14,The Other Side of Heaven,7000000,4720371,4720371,9440742,2440742,0.3486774285714286,2001,12
34,2002-06-07,Bad Company,70000000,30157016,69157016,99314032,29314032,0.4187718857142857,2002,6
34,2003-01-31,Final Destination 2,26000000,46896664,90396664,137293328,111293328,4.280512615384615,2003,1
34,2003-02-21,Old School,24000000,75155000,86765463,161920463,137920463,5.746685958333333,2003,2
34,2003-10-03,The Station Agent,500000,5801558,9470209,15271767,14771767,29.543534,2003,10
34,2004-09-10,Resident Evil: Apocalypse,50000000,50740078,125168734,175908812,125908812,2.51817624,2004,9
34,2005-07-08,Dark Water,60000000,25473093,49473093,74946186,14946186,0.2491031,2005,7
34,2006-06-16,The Lake House,40000000,52330111,114830111,167160222,127160222,3.17900555,2006,6
34,2006-07-28,Miami Vice,135000000,63478838,163818556,227297394,92297394,0.6836844,2006,7
34,2006-09-27,The Last King of Scotland,6000000,17606684,49155371,66762055,60762055,10.127009166666667,2006,9
34,2006-10-13,Alex Rider: Operation Stormbreaker,40000000,659210,20722450,21381660,-18618340,-0.4654585,2006,10
34,2006-11-22,The Fountain,35000000,10144010,15461638,25605648,-9394352,-0.26841005714285715,2006,11
34,2007-06-15,The Trials of Darryl Hunt,200000,1217,1217,2434,-197566,-0.98783,2007,6
34,2008-04-04,Shine a Light,1000000,5505267,16173879,21679146,20679146,20.679146,2008,4
34,2008-06-20,The Love Guru,62000000,32235793,40159017,72394810,10394810,0.16765822580645162,2008,6
34,2010-04-30,Housefull,10100000,1183658,18726300,19909958,9809958,0.9712829702970297,2010,4
34,2010-06-25,Grown Ups,75000000,162001186,272223430,434224616,359224616,4.789661546666666,2010,6
34,2010-08-13,The Expendables,82000000,103068524,268268174,371336698,289336698,3.528496317073171,2010,8
34,2011-04-01,Super,2500000,327716,593933,921649,-1578351,-0.6313404,2011,4
34,2011-07-08,Horrible Bosses,35000000,117538559,212417601,329956160,294956160,8.427318857142858,2011,7
34,2011-07-29,Cowboys and Aliens,163000000,100368560,176038324,276406884,113406884,0.695747754601227,2011,7
34,2011-10-14,Fireflies in the Garden,8000000,36884,3587191,3624075,-4375925,-0.546990625,2011,10
34,2011-11-25,The Artist,16000000,44667095,128256712,172923807,156923807,9.8077379375,2011,11
34,2012-04-13,L!fe Happens,930000,30905,30905,61810,-868190,-0.9335376344086022,2012,4
34,2012-04-20,Darling Companion,12000000,793352,1200346,1993698,-10006302,-0.8338585,2012,4
34,2012-04-27,The Pirates! Band of Misfits,55000000,31051126,136143605,167194731,112194731,2.0399042,2012,4
34,2013-02-14,A Good Day to Die Hard,92000000,67349198,304249198,371598396,279598396,3.039113,2013,2
34,2014-07-02,Deliver Us from Evil,30000000,30577122,87956618,118533740,88533740,2.951124666666667,2014,7
34,2014-10-31,Nightcrawler,8500000,32381218,50334418,82715636,74215636,8.731251294117648,2014,10
34,2015-05-08,The D Train,3000000,669688,772366,1442054,-1557946,-0.5193153333333334,2015,5
34,2015-06-12,Jurassic World,215000000,652270625,1648854864,-1993841807,2086125489,9.70290925116279,2015,6
34,2015-09-04,The Transporter Refueled,22000000,16029670,69698495,85728165,63728165,2.8967347727272728,2015,9
34,2015-11-06,Spotlight,20000000,45055776,92088460,137144236,117144236,5.8572118,2015,11
34,2016-03-18,The Divergent Series: Allegiant,110000000,66184051,172022517,238206568,128206568,1.1655142545454547,2016,3
34,2016-09-02,The Light Between Oceans,20000000,12545979,22281732,34827711,14827711,0.74138555,2016,9
34,2016-11-11,Arrival,47000000,100546139,203127894,303674033,256674033,5.461149638297872,2016,11
34,2017-08-25,Birth of the Dragon,31000000,6901965,7220490,14122455,-16877545,-0.544436935483871,2017,8
34,2019-04-05,The Best of Enemies,10000000,10205616,10205616,20411232,10411232,1.0411232,2019,4
35,1962-03-09,State Fair,4500000,3500000,3500000,7000000,2500000,0.5555555555555556,1962,3
35,1980-06-13,The Island,22000000,15716828,15716828,31433656,9433656,0.42880254545454544,1980,6
35,1987-07-31,The Lost Boys,8500000,32222567,32222567,64445134,55945134,6.581780470588235,1987,7
35,1990-09-28,Dark Angel,7000000,4372561,4372561,8745122,1745122,0.24930314285714286,1990,9
35,1995-10-20,Get Shorty,30250000,72021008,115021008,187042016,156792016,5.183207140495868,1995,10
35,1996-06-14,The Cable Guy,47000000,60240295,102825796,163066091,116066091,2.4694912978723402,1996,6
35,1998-01-23,Spice World,25000000,29342592,56042592,85385184,60385184,2.41540736,1998,1
35,1998-04-03,The Spanish Prisoner,10000000,10162034,13835130,23997164,13997164,1.3997164,1998,4
35,1998-08-14,The Avengers,60000000,23385416,48585416,71970832,11970832,0.19951386666666668,1998,8
35,1999-06-18,Lola rennt,1750000,7267324,22879194,30146518,28396518,16.226581714285714,1999,6
35,1999-10-29,House on Haunted Hill,19000000,40846082,65090541,105936623,86936623,4.575611736842105,1999,10
35,2000-11-17,The 6th Day,82000000,34543701,96024898,130568599,48568599,0.592299987804878,2000,11
35,2000-12-22,"O Brother, Where Art Thou?",26000000,45506619,75763814,121270433,95270433,3.664247423076923,2000,12
35,2001-02-23,3000 Miles to Graceland,62000000,15738632,18708848,34447480,-27552520,-0.4443954838709677,2001,2
35,2001-03-30,Spy Kids,35000000,112692062,197692062,310384124,275384124,7.868117828571428,2001,3
35,2001-07-13,Made,5000000,5308707,5476060,10784767,5784767,1.1569534,2001,7
35,2002-11-08,Far From Heaven,13500000,15901849,29027914,44929763,31429763,2.3281305925925926,2002,11
35,2003-03-07,Irreversible,5400000,792200,8133256,8925456,3525456,0.6528622222222222,2003,3
35,2003-04-16,A Mighty Wind,6000000,17583468,18504539,36088007,30088007,5.014667833333333,2003,4
35,2004-04-09,The Alamo,92000000,22406362,23911362,46317724,-45682276,-0.49654647826086956,2004,4
35,2004-09-03,Tae Guik Gi: The Brotherhood of War,12500000,1110186,69826708,70936894,58436894,4.67495152,2004,9
35,2004-10-01,Shark Tale,75000000,161412000,371917043,533329043,458329043,6.111053906666666,2004,10
35,2005-06-24,La marche de l'empereur,3400000,77437223,133276359,210713582,207313582,60.97458294117647,2005,6
35,2005-09-23,Dear Wendy,8000000,23106,446438,469544,-7530456,-0.941307,2005,9
35,2005-10-21,Doom,70000000,28212337,58757178,86969515,16969515,0.24242164285714285,2005,10
35,2005-10-28,The Weather Man,20000000,12482775,15466961,27949736,7949736,0.3974868,2005,10
35,2005-12-02,Aeon Flux,55000000,25857987,53913573,79771560,24771560,0.450392,2005,12
35,2006-12-20,Rocky Balboa,24000000,70269899,156229050,226498949,202498949,8.437456208333334,2006,12
35,2007-08-24,September Dawn,10100000,1066555,1066555,2133110,-7966890,-0.78880099009901,2007,8
35,2008-11-14,Fuel,2500000,174255,174255,348510,-2151490,-0.860596,2008,11
35,2009-01-09,The Unborn,16000000,42670410,78208812,120879222,104879222,6.554951375,2009,1
35,2009-05-22,The Girlfriend Experience,1300000,695840,1005840,1701680,401680,0.30898461538461536,2009,5
35,2009-06-12,The Taking of Pelham 123,110000000,65452312,152364370,217816682,107816682,0.9801516545454545,2009,6
35,2009-11-20,Red Cliff,40000000,627047,119627047,120254094,80254094,2.00635235,2009,11
35,2010-01-22,To Save a Life,500000,3777210,3824868,7602078,7102078,14.204156,2010,1
35,2010-06-04,Ondine,12000000,550472,557545,1108017,-10891983,-0.90766525,2010,6
35,2010-07-09,Predators,40000000,52000688,127234389,179235077,139235077,3.480876925,2010,7
35,2012-03-23,October Baby,1000000,5355847,5391992,10747839,9747839,9.747839,2012,3
35,2012-05-25,Men in Black 3,215000000,179020854,654213485,833234339,618234339,2.875508553488372,2012,5
35,2012-09-07,Bachelorette,3000000,446770,12577401,13024171,10024171,3.3413903333333335,2012,9
35,2013-06-28,The Heat,43000000,159581587,229727774,389309361,346309361,8.053706069767442,2013,6
35,2013-11-29,Mandela: Long Walk to Freedom,35000000,8323085,29890402,38213487,3213487,0.09181391428571428,2013,11
35,2014-08-01,Get on Up,30000000,30569935,33339868,63909803,33909803,1.1303267666666668,2014,8
35,2014-10-17,The Book of Life,50000000,50151543,97651543,147803086,97803086,1.95606172,2014,10
35,2014-11-07,The Theory of Everything,15000000,35893537,123327692,159221229,144221229,9.6147486,2014,11
35,2015-08-07,The Diary of a Teenage Girl,2000000,1477002,2279959,3756961,1756961,0.8784805,2015,8
35,2015-08-14,Straight Outta Compton,28000000,161197785,202182981,363380766,335380766,11.9778845,2015,8
35,2016-03-18,Midnight Special,18000000,3712282,7680250,11392532,-6607468,-0.36708155555555555,2016,3
35,2017-02-03,The Comedian,15000000,1658706,1658706,3317412,-11682588,-0.7788392,2017,2
35,2017-03-17,Beauty and the Beast,160000000,504014165,1259199706,1763213871,1603213871,10.02008669375,2017,3
35,2017-05-12,Lowriders,916000,6179955,6188421,12368376,11452376,12.502593886462883,2017,5
35,2018-03-30,Acrimony,20000000,43549096,46627836,90176932,70176932,3.5088466,2018,3
35,2018-11-02,The Nutcracker and the Four Realms,132900000,54858851,170293899,225152750,92252750,0.6941516177577126,2018,11
35,2019-06-07,Late Night,4000000,246305,246305,492610,-3507390,-0.8768475,2019,6
36,1977-12-23,High Anxiety,3400000,31063038,31063038,62126076,58726076,17.272375294117648,1977,12
36,1984-06-08,Ghostbusters,30000000,242212467,295212467,537424934,507424934,16.914164466666666,1984,6
36,1986-06-27,American Anthem,7000000,3571624,3571624,7143248,143248,0.020464,1986,6
36,1995-12-22,Cutthroat Island,92000000,10017322,18517322,28534644,-63465356,-0.6898408260869565,1995,12
36,1996-08-02,Chain Reaction,55000000,21226204,60209334,81435538,26435538,0.4806461454545455,1996,8
36,1997-02-14,Absolute Power,50000000,50068310,50068310,100136620,50136620,1.0027324,1997,2
36,1999-06-11,Le Violon rouge,10000000,10019109,10019109,20038218,10038218,1.0038218,1999,6
36,2000-01-28,The Big Tease,4000000,185577,185577,371154,-3628846,-0.9072115,2000,1
36,2000-07-14,X-Men,75000000,157299717,296872367,454172084,379172084,5.055627786666666,2000,7
36,2000-12-19,Finding Forrester,43000000,51768623,80013623,131782246,88782246,2.0647033953488374,2000,12
36,2001-04-11,Josie and the Pussycats,22000000,14252830,14252830,28505660,6505660,0.2957118181818182,2001,4
36,2001-04-27,Akira,8000000,19585,19585,39170,-7960830,-0.99510375,2001,4
36,2001-07-20,Brother,12000000,450594,450594,901188,-11098812,-0.924901,2001,7
36,2002-08-02,The Master of Disguise,16000000,40363530,40363530,80727060,64727060,4.04544125,2002,8
36,2002-08-23,Undisputed,20000000,12398628,12398628,24797256,4797256,0.2398628,2002,8
36,2003-02-07,May,1750000,145540,634803,780343,-969657,-0.5540897142857143,2003,2
36,2004-09-24,The Last Shot,40000000,463730,463730,927460,-39072540,-0.9768135,2004,9
36,2004-11-19,La mala educaciÃ³n,5000000,5211842,40311842,45523684,40523684,8.1047368,2004,11
36,2004-12-29,In Good Company,26000000,45489752,63489752,108979504,82979504,3.1915193846153844,2004,12
36,2005-06-29,War of the Worlds,132000000,234280354,606836535,841116889,709116889,5.372097643939394,2005,6
36,2006-06-16,Wordplay,500000,3121270,3177636,6298906,5798906,11.597812,2006,6
36,2006-09-15,The Black Dahlia,60000000,22672813,49238525,71911338,11911338,0.1985223,2006,9
36,2007-03-23,Journey from the Fall,1300000,635305,635305,1270610,-29390,-0.022607692307692308,2007,3
36,2007-07-27,No End In Sight,2000000,1433319,1433319,2866638,866638,0.433319,2007,7
36,2008-03-14,Funny Games,15000000,1294640,8200127,9494767,-5505233,-0.3670155333333333,2008,3
36,2008-10-24,LÃ¥t den rÃ¤tte komma in,4500000,2122085,12247682,14369767,9869767,2.1932815555555556,2008,10
36,2008-12-05,Punisher: War Zone,35000000,8050977,10157534,18208511,-16791489,-0.4797568285714286,2008,12
36,2009-04-22,Earth,47000000,32011576,116773317,148784893,101784893,2.1656360212765957,2009,4
36,2009-06-24,Transformers: Revenge of the Fallen,210000000,402111870,836519699,1238631569,1028631569,4.898245566666667,2009,6
36,2010-01-15,Fish Tank,3000000,374675,5922292,6296967,3296967,1.098989,2010,1
36,2010-02-26,The Crazies,19000000,39123589,56445534,95569123,76569123,4.029953842105263,2010,2
36,2010-04-09,Valley of the Hearts Delight,2500000,118666,118666,237332,-2262668,-0.9050672,2010,4
36,2010-04-16,The Perfect Game,12500000,1089445,3931367,5020812,-7479188,-0.59833504,2010,4
36,2011-09-16,Drive,15000000,35060689,81357930,116418619,101418619,6.761241266666667,2011,9
36,2012-08-15,The Odd Life of Timothy Green,40000000,51853450,55249159,107102609,67102609,1.677565225,2012,8
36,2012-10-12,Seven Psychopaths,13500000,15024049,33035736,48059785,34559785,2.559984074074074,2012,10
36,2013-11-01,Ender's Game,110000000,61737191,127983283,189720474,79720474,0.7247315818181819,2013,11
36,2014-04-11,Draft Day,25000000,28842237,29847480,58689717,33689717,1.34758868,2014,4
36,2014-06-20,Think Like a Man Too,24000000,65028687,70027933,135056620,111056620,4.6273591666666665,2014,6
36,2014-09-12,The Skeleton Twins,1000000,5284309,5797192,11081501,10081501,10.081501,2014,9
36,2014-10-03,Gone Girl,61000000,167767189,368567189,536334378,475334378,7.792366852459017,2014,10
36,2015-06-26,Max,20000000,42656255,43658157,86314412,66314412,3.3157206,2015,6
36,2015-07-17,Trainwreck,35000000,110212700,141123897,251336597,216336597,6.181045628571429,2015,7
36,2016-01-29,The Finest Hours,70000000,27569558,49252761,76822319,6822319,0.0974617,2016,1
36,2016-11-25,Miss Sloane,18000000,3500605,7719630,11220235,-6779765,-0.3766536111111111,2016,11
36,2017-07-21,Girls Trip,28000000,115108515,140886353,255994868,227994868,8.142673857142857,2017,7
36,2017-12-25,Mollyâs Game,30000000,28780744,53296424,82077168,52077168,1.7359056,2017,12
36,2018-10-19,Halloween,10000000,159342015,254900667,414242682,404242682,40.4242682,2018,10
36,2018-12-21,Aquaman,160000000,335061807,1146894640,1481956447,1321956447,8.26222779375,2018,12
36,2019-01-16,Dragon Ball Super: Broly,8500000,30376755,122747755,153124510,144624510,17.014648235294118,2019,1
36,2019-02-08,The Prodigy,6000000,14856291,19789712,34646003,28646003,4.774333833333333,2019,2
37,1954-07-28,On the Waterfront,910000,9600000,9600000,19200000,18290000,20.0989010989011,1954,7
37,1978-10-17,Halloween,325000,47000000,70000000,117000000,116675000,359.0,1978,10
37,1979-11-07,The Rose,8500000,29200000,29200000,58400000,49900000,5.870588235294117,1979,11
37,1987-07-31,The Living Daylights,40000000,51185000,191200000,242385000,202385000,5.059625,1987,7
37,1994-09-23,The Shawshank Redemption,25000000,28241469,28307092,56548561,31548561,1.26194244,1994,9
37,1995-11-22,Toy Story,30000000,191796233,364545516,556341749,526341749,17.544724966666667,1995,11
37,1996-08-16,The Fan,55000000,18582965,18582965,37165930,-17834070,-0.3242558181818182,1996,8
37,1997-12-05,Good Will Hunting,10000000,138433435,225925989,364359424,354359424,35.4359424,1997,12
37,1998-11-20,The Rugrats Movie,28000000,100494685,140894685,241389370,213389370,7.621048928571429,1998,11
37,1998-11-25,Very Bad Things,10000000,9949470,21094974,31044444,21044444,2.1044444,1998,11
37,1999-02-12,Tango,4500000,1687311,5428387,7115698,2615698,0.5812662222222222,1999,2
37,1999-03-26,EDtv,60000000,22508689,35319689,57828378,-2171622,-0.0361937,1999,3
37,1999-10-22,Beyond the Mat,500000,2047570,2047570,4095140,3595140,7.19028,1999,10
37,2000-03-31,The Skulls,15000000,35007180,35007180,70014360,55014360,3.667624,2000,3
37,2000-04-14,28 Days,43000000,37035515,62063972,99099487,56099487,1.3046392325581395,2000,4
37,2000-05-05,The Basket,1300000,609042,609042,1218084,-81916,-0.06301230769230769,2000,5
37,2000-11-22,Quills,13500000,7060876,11732088,18792964,5292964,0.3920714074074074,2000,11
37,2001-10-19,Riding in Cars with Boys,47000000,29781453,29781453,59562906,12562906,0.2672958723404255,2001,10
37,2002-10-04,Welcome to Collinwood,12000000,378650,4606284,4984934,-7015066,-0.5845888333333333,2002,10
37,2003-05-23,Bruce Almighty,81000000,242704995,484468608,727173603,646173603,7.977451888888889,2003,5
37,2003-09-05,The Order,35000000,7659747,11559747,19219494,-15780506,-0.4508716,2003,9
37,2004-04-02,Home on the Range,110000000,50026353,76482461,126508814,16508814,0.15008012727272727,2004,4
37,2004-11-12,Veer-Zaara,7000000,2938532,7017859,9956391,2956391,0.4223415714285714,2004,11
37,2006-01-27,Rang De Basanti,5300000,2197694,29197694,31395388,26095388,4.923658113207547,2006,1
37,2006-02-10,Firewall,50000000,48751189,82751189,131502378,81502378,1.63004756,2006,2
37,2006-06-02,Banlieue 13,15000000,1200216,11599903,12800119,-2199881,-0.14665873333333335,2006,6
37,2006-10-06,The Texas Chainsaw Massacre: The Beginning,16000000,39517763,50517763,90035526,74035526,4.627220375,2006,10
37,2007-03-16,Nomad,40000000,79123,79123,158246,-39841754,-0.99604385,2007,3
37,2007-03-30,Blades of Glory,61000000,118594548,145594548,264189096,203189096,3.330968786885246,2007,3
37,2007-05-17,Shrek the Third,160000000,322719944,807330936,1130050880,970050880,6.062818,2007,5
37,2008-03-21,Meet the Browns,20000000,41975388,41975388,83950776,63950776,3.1975388,2008,3
37,2008-06-27,Wanted,75000000,134508551,342416460,476925011,401925011,5.359000146666666,2008,6
37,2008-07-18,The Legend of God's Gun,30000,243768,243768,487536,457536,15.2512,2008,7
37,2008-09-05,Everybody Wants to Be Italian,3000000,351416,351416,702832,-2297168,-0.7657226666666667,2008,9
37,2008-10-31,The Other End of the Line,2500000,115504,507446,622950,-1877050,-0.75082,2008,10
37,2009-01-16,Notorious,19000000,36843682,44972183,81815865,62815865,3.306098157894737,2009,1
37,2009-03-27,12 Rounds,20000000,12234694,17306648,29541342,9541342,0.4770671,2009,3
37,2009-06-12,Moon,5000000,5010163,10676073,15686236,10686236,2.1372472,2009,6
37,2010-01-22,Legion,26000000,40168080,67647574,107815654,81815654,3.146755923076923,2010,1
37,2010-10-08,I Spit on Your Grave,1750000,93051,1278471,1371522,-378478,-0.21627314285714286,2010,10
37,2011-10-21,Margin Call,3400000,5353586,20433227,25786813,22386813,6.584356764705882,2011,10
37,2012-04-27,The Five-Year Engagement,30000000,28700285,61623819,90324104,60324104,2.0108034666666668,2012,4
37,2012-08-22,Hit & Run,22000000,13749300,17216955,30966255,8966255,0.40755704545454546,2012,8
37,2012-10-05,The Paperboy,12500000,677200,4027663,4704863,-7795137,-0.62361096,2012,10
37,2013-06-14,20 Feet From Stardom,1000000,4946250,5892466,10838716,9838716,9.838716,2013,6
37,2013-09-27,Metallica Through the Never,18000000,3419967,9082906,12502873,-5497127,-0.30539594444444446,2013,9
37,2013-10-18,Escape Plan,70000000,25135965,103735965,128871930,58871930,0.8410275714285714,2013,10
37,2013-12-13,Saving Mr. Banks,35000000,83299761,114962525,198262286,163262286,4.664636742857143,2013,12
37,2013-12-25,The Secret Life of Walter Mitty,91000000,58236838,187861183,246098021,155098021,1.704373857142857,2013,12
37,2014-04-25,Locke,2000000,1370646,2088390,3459036,1459036,0.729518,2014,4
37,2014-06-27,Transformers: Age of Extinction,210000000,245439076,1104039076,1349478152,1139478152,5.426086438095238,2014,6
37,2014-11-26,Penguins of Madagascar,132000000,83350911,366942531,450293442,318293442,2.4113139545454545,2014,11
37,2016-12-16,Fences,24000000,57682904,64282881,121965785,97965785,4.0819077083333335,2016,12
37,2017-08-25,Polina danser sa vie,4000000,165203,953314,1118517,-2881483,-0.72037075,2017,8
37,2018-11-30,The Possession of Hannah Grace,6000000,14836174,42785387,57621561,51621561,8.6035935,2018,11
38,1934-02-22,It Happened One Night,325000,2500000,2500000,5000000,4675000,14.384615384615385,1934,2
38,1966-10-10,Hawaii,15000000,34562222,34562222,69124444,54124444,3.6082962666666667,1966,10
38,1979-12-07,Star Trek: The Motion Picture,35000000,82258456,139000000,221258456,186258456,5.321670171428571,1979,12
38,1982-01-29,The Border,13500000,6118683,6118683,12237366,-1262634,-0.09352844444444444,1982,1
38,1986-04-23,Salvador,4500000,1500000,1500000,3000000,-1500000,-0.3333333333333333,1986,4
38,1988-02-12,School Daze,6000000,14545844,14545844,29091688,23091688,3.8486146666666667,1988,2
38,1988-07-15,Die Hard,28000000,81350242,139109346,220459588,192459588,6.873556714285714,1988,7
38,1996-06-07,The Rock,75000000,134069511,336069511,470139022,395139022,5.268520293333333,1996,6
38,1997-06-13,Speed 2: Cruise Control,110000000,48097081,150468000,198565081,88565081,0.8051371,1997,6
38,1997-09-12,The Game,50000000,48265581,80369970,128635551,78635551,1.57271102,1997,9
38,1999-04-30,Get Real,2000000,1152411,1152411,2304822,304822,0.152411,1999,4
38,1999-11-12,Felicia's Journey,15000000,824295,1970268,2794563,-12205437,-0.8136958,1999,11
38,2000-02-18,The Whole Nine Yards,24000000,57262492,85527867,142790359,118790359,4.949598291666667,2000,2
38,2000-10-27,The Little Vampire,22000000,13555988,13555988,27111976,5111976,0.23236254545454546,2000,10
38,2002-02-01,The Singles Ward,500000,1250798,1250798,2501596,2001596,4.003192,2002,2
38,2003-09-19,Anything Else,18000000,3203044,13203044,16406088,-1593912,-0.08855066666666667,2003,9
38,2004-04-02,The Prince & Me,30000000,28165882,29356757,57522639,27522639,0.9174213,2004,4
38,2004-07-09,Sleepover,10000000,9408183,9408183,18816366,8816366,0.8816366,2004,7
38,2004-10-22,The Grudge,10000000,110359362,187281115,297640477,287640477,28.7640477,2004,10
38,2005-05-13,Danny the Dog,43000000,24537621,49037621,73575242,30575242,0.7110521395348838,2005,5
38,2006-05-26,X-Men: The Last Stand,210000000,234362462,459260946,693623408,483623408,2.3029686095238096,2006,5
38,2006-11-10,A Good Year,35000000,7459300,42064105,49523405,14523405,0.41495442857142856,2006,11
38,2006-12-08,Apocalypto,40000000,50866635,121032272,171898907,131898907,3.297472675,2006,12
38,2006-12-29,El Laberinto del Fauno,16000000,37634615,87041569,124676184,108676184,6.7922615,2006,12
38,2007-01-05,Happily N'Ever After,47000000,15849032,37923818,53772850,6772850,0.1441031914893617,2007,1
38,2007-10-12,Elizabeth: The Golden Age,55000000,16285240,74870866,91156106,36156106,0.6573837454545455,2007,10
38,2008-04-18,Life Before Her Eyes,12000000,303439,7203439,7506878,-4493122,-0.3744268333333333,2008,4
38,2008-05-02,Redbelt,7000000,2344847,2667084,5011931,-1988069,-0.28400985714285715,2008,5
38,2008-09-26,Choke,3400000,2926565,4124277,7050842,3650842,1.0737770588235294,2008,9
38,2008-12-25,The Spirit,60000000,19806188,39006188,58812376,-1187624,-0.019793733333333334,2008,12
38,2009-06-12,"Food, Inc.",1000000,4417674,4731944,9149618,8149618,8.149618,2009,6
38,2009-07-24,Orphan,20000000,41596251,78769428,120365679,100365679,5.01828395,2009,7
38,2010-06-18,8: The Mormon Proposition,2500000,100280,100280,200560,-2299440,-0.919776,2010,6
38,2010-07-16,Inception,160000000,292576195,835524642,1128100837,968100837,6.05063023125,2010,7
38,2010-10-01,Let Me In,20000000,12134935,28270399,40405334,20405334,1.0202667,2010,10
38,2011-09-09,Creature,3000000,331000,331000,662000,-2338000,-0.7793333333333333,2011,9
38,2011-09-23,Killer Elite,70000000,25124986,65409046,90534032,20534032,0.2933433142857143,2011,9
38,2012-03-23,The Hunger Games,80000000,408010692,677923379,1085934071,1005934071,12.5741758875,2012,3
38,2012-08-29,Lawless,26000000,37397291,54393687,91790978,65790978,2.5304222307692306,2012,8
38,2013-03-01,Ernest et Celestine,12500000,292562,9376444,9669006,-2830994,-0.22647952,2013,3
38,2013-07-12,Fruitvale Station,900000,16098998,17549645,33648643,32748643,36.38738111111111,2013,7
38,2013-09-27,Baggage Claim,8500000,21569509,22885836,44455345,35955345,4.230040588235294,2013,9
38,2013-11-22,The Hunger Games: Catching Fire,130000000,424668047,864868047,1289536094,1159536094,8.919508415384616,2013,11
38,2015-01-30,Above and Beyond,1300000,288751,288751,577502,-722498,-0.5557676923076923,2015,1
38,2015-04-10,Desert Dancer,4000000,155271,596335,751606,-3248394,-0.8120985,2015,4
38,2015-09-11,90 Minutes in Heaven,5000000,4816142,4816142,9632284,4632284,0.9264568,2015,9
38,2015-09-18,Maze Runner: The Scorch Trials,61000000,81697192,310566162,392263354,331263354,5.4305467868852455,2015,9
38,2016-03-18,Krisha,30000,144822,144822,289644,259644,8.6548,2016,3
38,2017-02-03,Rings,25000000,27793018,82917283,110710301,85710301,3.42841204,2017,2
38,2017-12-20,Jumanji: Welcome to the Jungle,90000000,404508916,964496193,1369005109,1279005109,14.211167877777777,2017,12
38,2018-08-15,Crazy Rich Asians,30000000,174532921,238099711,412632632,382632632,12.754421066666668,2018,8
38,2018-11-02,Nobodyâs Fool,19000000,31713110,32589493,64302603,45302603,2.3843475263157896,2018,11
39,1985-03-15,Def-Con 4,1300000,210904,210904,421808,-878192,-0.6755323076923077,1985,3
39,1994-05-06,3 Ninjas Kick Back,20000000,11744960,11744960,23489920,3489920,0.174496,1994,5
39,1996-02-23,Unforgettable,18000000,2483790,2483790,4967580,-13032420,-0.7240233333333334,1996,2
39,1997-07-01,Men in Black,90000000,250690539,587790539,838481078,748481078,8.316456422222222,1997,7
39,1997-08-22,G.I. Jane,50000000,48169156,48169156,96338312,46338312,0.92676624,1997,8
39,1997-10-31,Critical Care,12000000,220175,220175,440350,-11559650,-0.9633041666666666,1997,10
39,1998-01-16,Hard Rain,70000000,19870567,19870567,39741134,-30258866,-0.4322695142857143,1998,1
39,1999-08-27,A Dog of Flanders,7000000,2165637,2165637,4331274,-2668726,-0.38124657142857143,1999,8
39,2001-04-06,Along Came a Spider,28000000,74058698,105159085,179217783,151217783,5.4006351071428575,2001,4
39,2001-10-19,The Last Castle,60000000,18208078,20541668,38749746,-21250254,-0.3541709,2001,10
39,2001-10-26,Donnie Darko,4500000,1480006,7510877,8990883,4490883,0.997974,2001,10
39,2001-11-23,In the Bedroom,1700000,35930604,42137871,78068475,76368475,44.92263235294118,2001,11
39,2002-01-25,Metropolis,15000000,673414,1405032,2078446,-12921554,-0.8614369333333334,2002,1
39,2002-03-29,Clockstoppers,26000000,36985501,38788828,75774329,49774329,1.9143972692307691,2002,3
39,2002-04-12,The Sweetest Thing,43000000,24430272,63078756,87509028,44509028,1.0350936744186046,2002,4
39,2002-11-27,Solaris,47000000,14970038,14970038,29940076,-17059924,-0.3629771063829787,2002,11
39,2002-12-27,Chicago,30000000,170687518,306770545,477458063,447458063,14.915268766666667,2002,12
39,2004-02-13,50 First Dates,75000000,120776832,196320329,317097161,242097161,3.2279621466666666,2004,2
39,2004-04-23,L\'incomparable mademoiselle C.,3400000,493905,493905,987810,-2412190,-0.7094676470588235,2004,4
39,2004-06-04,Harry Potter and the Prisoner of Azkaban,130000000,249757726,796907323,1046665049,916665049,7.051269607692308,2004,6
39,2004-10-01,I Heart Huckabees,22000000,12784713,20034713,32819426,10819426,0.49179209090909093,2004,10
39,2005-02-18,Der Untergang,13500000,5501940,93631744,99133684,85633684,6.343235851851852,2005,2
39,2005-05-06,Kingdom of Heaven,110000000,47398413,218853353,266251766,156251766,1.4204706,2005,5
39,2006-09-01,Mutual Appreciation,30000,103509,103509,207018,177018,5.9006,2006,9
39,2007-02-14,Music and Lyrics,40000000,50572589,146196885,196769474,156769474,3.91923685,2007,2
39,2007-08-08,Daddy Day Camp,6000000,13235267,18209872,31445139,25445139,4.2408565,2007,8
39,2007-09-07,In the Shadow of the Moon,2000000,1134358,2175587,3309945,1309945,0.6549725,2007,9
39,2008-03-28,21,35000000,81159365,159846429,241005794,206005794,5.885879828571428,2008,3
39,2009-04-17,Sleep Dealer,2500000,80136,108907,189043,-2310957,-0.9243828,2009,4
39,2009-05-22,Dance Flick,25000000,25794018,32224624,58018642,33018642,1.32074568,2009,5
39,2009-06-12,Imagine That,55000000,16222392,22438144,38660536,-16339464,-0.2970811636363636,2009,6
39,2010-05-14,Robin Hood,210000000,105487148,322459006,427946154,217946154,1.0378388285714286,2010,5
39,2010-06-25,Kynodontas,323000,110248,1373407,1483655,1160655,3.593359133126935,2010,6
39,2010-08-20,The Switch,19000000,27758465,49858465,77616930,58616930,3.0851015789473686,2010,8
39,2011-02-04,The Roommate,16000000,37300107,52545707,89845814,73845814,4.615363375,2011,2
39,2011-05-26,The Hangover Part II,80000000,254464305,586464305,840928610,760928610,9.511607625,2011,5
39,2011-07-08,Sholem Aleichem: Laughing in the Darkness,500000,1131261,1131261,2262522,1762522,3.525044,2011,7
39,2011-07-15,Winnie the Pooh,30000000,26692846,50145607,76838453,46838453,1.5612817666666667,2011,7
39,2011-10-14,Footloose,24000000,51802742,62989834,114792576,90792576,3.783024,2011,10
39,2012-05-04,A Little Bit of Heaven,12500000,10011,1100287,1110298,-11389702,-0.91117616,2012,5
39,2013-01-25,Movie 43,10000000,8840453,31164747,40005200,30005200,3.00052,2013,1
39,2013-08-02,2 Guns,61000000,75612460,132493015,208105475,147105475,2.4115651639344264,2013,8
39,2013-10-11,La Vie d'AdÃ¨le â Chapitres 1 & 2,5250000,2450504,22914479,25364983,20114983,3.8314253333333332,2013,10
39,2015-01-30,"Guten Tag, Ramon",4000000,154356,4854356,5008712,1008712,0.252178,2015,1
39,2015-11-20,The Hunger Games: Mockingjay - Part 2,160000000,281723902,648986787,930710689,770710689,4.81694180625,2015,11
39,2016-03-11,The Brothers Grimsby,35000000,6864016,28720470,35584486,584486,0.0166996,2016,3
39,2016-04-01,Meet the Blacks,900000,9097072,9097072,18194144,17294144,19.215715555555555,2016,4
39,2016-08-26,Donât Breathe,10000000,89217875,158973685,248191560,238191560,23.819156,2016,8
39,2016-10-07,Middle School: The Worst Years of My Life,8500000,20007149,23311293,43318442,34818442,4.096287294117647,2016,10
39,2016-12-02,Incarnate,5000000,4799774,9371036,14170810,9170810,1.834162,2016,12
39,2016-12-09,The Bounce Back,3000000,321910,421404,743314,-2256686,-0.7522286666666667,2016,12
39,2017-07-28,An Inconvenient Sequel,1000000,3496795,5839322,9336117,8336117,8.336117,2017,7
39,2017-11-17,The Star,20000000,40847995,62758010,103606005,83606005,4.18030025,2017,11
39,2018-11-23,The Favourite,15000000,34366783,94113929,128480712,113480712,7.5653808,2018,11
40,1981-06-26,Stripes,10000000,85300000,85300000,170600000,160600000,16.06,1981,6
40,1985-07-10,Silverado,26000000,33200000,33200000,66400000,40400000,1.5538461538461539,1985,7
40,1986-06-18,Legal Eagles,40000000,49851591,49851591,99703182,59703182,1.49257955,1986,6
40,1988-10-21,Mystic Pizza,6000000,12793213,12793213,25586426,19586426,3.2644043333333332,1988,10
40,1988-11-18,The Land Before Time,12300000,48092846,81972846,130065692,117765692,9.57444650406504,1988,11
40,1991-03-01,Haakon Haakonsen,8500000,15024232,15024232,30048464,21548464,2.535113411764706,1991,3
40,1996-05-21,Mission: Impossible,80000000,180981886,457697994,638679880,558679880,6.9834985,1996,5
40,1996-08-23,Freeway,3000000,295493,295493,590986,-2409014,-0.8030046666666667,1996,8
40,1998-05-15,Bulworth,30000000,26528684,29203383,55732067,25732067,0.8577355666666666,1998,5
40,1998-08-21,Next Stop Wonderland,1000000,3395581,3465703,6861284,5861284,5.861284,1998,8
40,1999-06-25,Big Daddy,30000000,163479795,228641283,392121078,362121078,12.0707026,1999,6
40,1999-11-19,Toy Story 2,90000000,245852179,511358276,757210455,667210455,7.4134495,1999,11
40,1999-11-24,Tumbleweeds,312000,1350248,1788168,3138416,2826416,9.059025641025642,1999,11
40,2001-03-02,The Caveman's Valentine,13500000,687081,892506,1579587,-11920413,-0.8829935555555556,2001,3
40,2001-04-20,Crocodile Dundee in Los Angeles,25000000,25590119,39393111,64983230,39983230,1.5993292,2001,4
40,2002-02-15,Hart's War,70000000,19076815,33076815,52153630,-17846370,-0.25494814285714285,2002,2
40,2002-10-18,Auto Focus,7000000,2062066,2703821,4765887,-2234113,-0.319159,2002,10
40,2003-02-21,Gods and Generals,55000000,12882934,12923936,25806870,-29193130,-0.5307841818181818,2003,2
40,2003-04-18,Malibu's Most Wanted,15000000,34308901,34499204,68808105,53808105,3.587207,2003,4
40,2003-07-25,Mondays in the Sun,4000000,146402,146402,292804,-3707196,-0.926799,2003,7
40,2004-01-30,Osama,500000,1127331,1971479,3098810,2598810,5.19762,2004,1
40,2005-04-29,Funny Ha Ha,30000,77070,82698,159768,129768,4.3256,2005,4
40,2005-12-09,Neal n' Nikki,1300000,100358,329621,429979,-870021,-0.6692469230769231,2005,12
40,2005-12-14,King Kong,207000000,218080025,550517357,768597382,561597382,2.7130308309178743,2005,12
40,2006-05-12,Keeping Up with the Steins,5000000,4339241,4414753,8753994,3753994,0.7507988,2006,5
40,2007-01-26,Epic Movie,20000000,39739367,86858578,126597945,106597945,5.32989725,2007,1
40,2007-02-02,The Messengers,16000000,35374833,53774833,89149666,73149666,4.571854125,2007,2
40,2007-07-20,Hairspray,75000000,118871849,203035572,321907421,246907421,3.2920989466666666,2007,7
40,2007-08-03,The Bourne Ultimatum,130000000,227471070,444043396,671514466,541514466,4.165495892307693,2007,8
40,2007-08-24,Eye of the Dolphin,2500000,72210,72260,144470,-2355530,-0.942212,2007,8
40,2007-09-28,Trade,12000000,214202,1513388,1727590,-10272410,-0.8560341666666667,2007,9
40,2008-01-25,"4 luni, 3 saptamani si 2 zile",900000,1196321,11993156,13189477,12289477,13.654974444444445,2008,1
40,2008-02-22,Be Kind Rewind,20000000,11175164,30894247,42069411,22069411,1.10347055,2008,2
40,2008-03-19,La misma luna,1700000,12590147,23271741,35861888,34161888,20.09522823529412,2008,3
40,2008-05-09,What Happens in Vegas...,35000000,80277646,218535708,298813354,263813354,7.5375244,2008,5
40,2008-07-11,August,3400000,12636,12636,25272,-3374728,-0.9925670588235294,2008,7
40,2009-01-23,Inkheart,60000000,17303424,66655938,83959362,23959362,0.3993227,2009,1
40,2010-01-08,Leap Year,19000000,25918920,32618920,58537840,39537840,2.080938947368421,2010,1
40,2010-06-18,Jonah Hex,47000000,10547117,11022696,21569813,-25430187,-0.5410678085106383,2010,6
40,2011-04-08,Meek's Cutoff,2000000,977772,1869928,2847700,847700,0.42385,2011,4
40,2011-09-02,Salvando al Soldado Perez,4500000,1400726,9330465,10731191,6231191,1.3847091111111112,2011,9
40,2012-04-27,Hodejegerne,5250000,1200010,20188740,21388750,16138750,3.074047619047619,2012,4
40,2013-05-24,Fast and Furious 6,160000000,238679850,789300444,1027980294,867980294,5.4248768375,2013,5
40,2014-08-08,Into the Storm,50000000,47602194,150429371,198031565,148031565,2.9606313,2014,8
40,2015-10-16,CÃ¬kÃ¨ NiÃ¨ YinniÃ¡ng,15000000,632542,11279884,11912426,-3087574,-0.20583826666666666,2015,10
40,2017-03-17,T2: Trainspotting,18000000,2402004,42091262,44493266,26493266,1.471848111111111,2017,3
40,2017-03-31,Ghost in the Shell,110000000,40563557,167910690,208474247,98474247,0.8952204272727273,2017,3
40,2017-04-07,Going in Style,24000000,45018541,78672579,123691120,99691120,4.153796666666667,2017,4
40,2017-10-20,The Snowman,35000000,6670765,43226146,49896911,14896911,0.42562602857142856,2017,10
40,2017-11-01,A Bad Moms Christmas,28000000,72110659,127710550,199821209,171821209,6.13647175,2017,11
40,2017-11-17,"Roman J. Israel, Esq.",22000000,11962712,12967012,24929724,2929724,0.13316927272727272,2017,11
40,2018-01-26,Maze Runner: The Death Cure,61000000,58032443,265878536,323910979,262910979,4.310016049180327,2018,1
40,2018-10-19,Can You Ever Forgive Me?,10000000,8803865,11752387,20556252,10556252,1.0556252,2018,10
40,2018-11-09,The Girl in the Spiderâs Web,43000000,14828555,34983342,49811897,6811897,0.15841620930232558,2018,11
41,1972-06-30,Conquest of the Planet of the Apes,1700000,9700000,9700000,19400000,17700000,10.411764705882353,1972,6
41,1975-06-20,Jaws,12000000,260000000,470700000,730700000,718700000,59.891666666666666,1975,6
41,1984-10-26,Body Double,10000000,8801940,8801940,17603880,7603880,0.760388,1984,10
41,1991-07-12,Point Break,24000000,43218387,83531958,126750345,102750345,4.281264375,1991,7
41,1991-11-15,Cape Fear,35000000,79091969,182291969,261383938,226383938,6.468112514285714,1991,11
41,1995-12-01,Things to Do in Denver when You're Dead,15000000,529766,529766,1059532,-13940468,-0.9293645333333334,1995,12
41,1996-02-23,Mary Reilly,47000000,5707094,12900000,18607094,-28392906,-0.6041043829787234,1996,2
41,1996-07-26,Kingpin,25000000,25023424,32223424,57246848,32246848,1.28987392,1996,7
41,1997-01-10,Turbulence,55000000,11532774,11532774,23065548,-31934452,-0.5806264,1997,1
41,1997-10-10,The Sweet Hereafter,5000000,4306697,7951247,12257944,7257944,1.4515888,1997,10
41,1998-03-20,Mr. Nice Guy,6000000,12716953,31716953,44433906,38433906,6.405651,1998,3
41,1998-03-27,Karakter,4500000,713413,713413,1426826,-3073174,-0.6829275555555555,1998,3
41,1999-04-23,Election,8500000,14943582,17202854,32146436,23646436,2.7819336470588234,1999,4
41,2000-01-14,Supernova,60000000,14218868,14816494,29035362,-30964638,-0.5160773,2000,1
41,2000-06-09,Groove,500000,1115313,1167524,2282837,1782837,3.565674,2000,6
41,2001-03-02,See Spot Run,16000000,33357476,43057552,76415028,60415028,3.77593925,2001,3
41,2001-08-03,Rush Hour 2,90000000,226164286,347425832,573590118,483590118,5.373223533333333,2001,8
41,2001-08-10,American Pie 2,30000000,145096820,286500000,431596820,401596820,13.386560666666666,2001,8
41,2002-02-08,Rollerball,70000000,18990542,25852508,44843050,-25156950,-0.359385,2002,2
41,2002-11-06,Femme Fatale,35000000,6630252,16830252,23460504,-11539496,-0.3296998857142857,2002,11
41,2003-06-13,Dumb and Dumberer: When Harry Met Lloyd,30000000,26214846,26214846,52429692,22429692,0.7476564,2003,6
41,2003-11-14,Tupac Resurrection,300000,7718961,7808524,15527485,15227485,50.75828333333333,2003,11
41,2003-12-19,The Hebrew Hammer,1300000,77755,90213,167968,-1132032,-0.8707938461538461,2003,12
41,2004-03-12,Secret Window,40000000,47958031,92111551,140069582,100069582,2.50173955,2004,3
41,2004-06-16,Around the World in 80 Days,110000000,24004159,72004159,96008318,-13991682,-0.1271971090909091,2004,6
41,2005-12-09,Mrs. Henderson Presents,20000000,11036366,27836366,38872732,18872732,0.9436366,2005,12
41,2006-01-06,Fateless,12000000,196857,196857,393714,-11606286,-0.9671905,2006,1
41,2006-10-06,Love's Abiding Joy,3000000,252726,252726,505452,-2494548,-0.831516,2006,10
41,2006-10-27,Saw III,10000000,80238724,163876815,244115539,234115539,23.4115539,2006,10
41,2007-08-03,The Ten,5250000,769726,786677,1556403,-3693597,-0.7035422857142857,2007,8
41,2007-12-07,The Golden Compass,205000000,70107728,367262558,437370286,232370286,1.1335135902439024,2007,12
41,2008-09-19,Lakeview Terrace,20000000,39263506,44821299,84084805,64084805,3.20424025,2008,9
41,2009-09-04,All About Steve,15000000,33862903,40127259,73990162,58990162,3.9326774666666666,2009,9
41,2009-12-04,Brothers,26000000,28544157,45043870,73588027,47588027,1.8303087307692307,2009,12
41,2009-12-30,Das Weisse Band: Eine deutsche Kindergeschichte,18000000,2222862,25727044,27949906,9949906,0.5527725555555556,2009,12
41,2010-10-15,Down Terrace,30000,9812,9812,19624,-10376,-0.34586666666666666,2010,10
41,2011-04-01,The Last Godfather,13400000,164247,164247,328494,-13071506,-0.9754855223880597,2011,4
41,2011-08-26,Circumstance,900000,454121,958978,1413099,513099,0.57011,2011,8
41,2011-10-21,The Mighty Macs,7000000,1891936,1891936,3783872,-3216128,-0.45944685714285716,2011,10
41,2013-02-14,Safe Haven,28000000,71399120,94050951,165450071,137450071,4.908931107142857,2013,2
41,2013-05-31,Now You See Me,75000000,117723989,342769200,460493189,385493189,5.139909186666666,2013,5
41,2013-08-16,Underdogs,2500000,35017,1392649,1427666,-1072334,-0.4289336,2013,8
41,2013-11-08,The Book Thief,19000000,21488481,76086711,97575192,78575192,4.135536421052632,2013,11
41,2013-12-04,Out of the Furnace,22000000,11330849,15434375,26765224,4765224,0.2166010909090909,2013,12
41,2014-05-16,Godzilla,160000000,200676069,529076069,729752138,569752138,3.5609508625,2014,5
41,2014-06-06,Obvious Child,1000000,3122616,3324070,6446686,5446686,5.446686,2014,6
41,2014-10-10,The Judge,50000000,47119388,76119388,123238776,73238776,1.46477552,2014,10
41,2014-11-28,The Babadook,2000000,950792,7482387,8433179,6433179,3.2165895,2014,11
41,2015-06-19,Manglehorn,4000000,132270,797439,929709,-3070291,-0.76757275,2015,6
41,2017-01-06,A Monster Calls,43000000,3740823,46414530,50155353,7155353,0.1664035581395349,2017,1
41,2017-02-10,The Lego Batman Movie,80000000,175750384,310660018,486410402,406410402,5.080130025,2017,2
41,2018-07-06,Ant-Man and the Wasp,130000000,216648740,623144660,839793400,709793400,5.45994923076923,2018,7
41,2019-01-11,A Dogâs Way Home,61000000,41952715,81149689,123102404,62102404,1.0180721967213116,2019,1
42,1956-08-21,War and Peace,6000000,12500000,12524028,25024028,19024028,3.1706713333333334,1956,8
42,1973-12-26,The Exorcist,12000000,230347346,428214478,658561824,646561824,53.880152,1973,12
42,1986-04-25,8 Million Ways to Die,18000000,1305114,1305114,2610228,-15389772,-0.8549873333333333,1986,4
42,1991-08-09,Double Impact,16000000,29090445,29090445,58180890,42180890,2.636305625,1991,8
42,1991-09-20,The Fisher King,24000000,41798224,41798224,83596448,59596448,2.483185333333333,1991,9
42,1993-02-12,Dead Alive,3000000,242623,242623,485246,-2514754,-0.8382513333333333,1993,2
42,1993-11-05,RoboCop 3,22000000,10696210,10696210,21392420,-607580,-0.027617272727272726,1993,11
42,1996-11-15,The English Patient,35000000,78716374,231710008,310426382,275426382,7.8693252,1996,11
42,1997-05-02,Warriors of Virtue,35000000,6448817,6448817,12897634,-22102366,-0.6314961714285714,1997,5
42,1997-12-12,Deconstructing Harry,20000000,10686841,10686841,21373682,1373682,0.0686841,1997,12
42,2000-03-10,God's Army,300000,2637726,2652515,5290241,4990241,16.634136666666667,2000,3
42,2000-04-28,Where the Heart Is,15000000,33771174,40862054,74633228,59633228,3.9755485333333334,2000,4
42,2000-09-08,Anatomie,2500000,9598,9598,19196,-2480804,-0.9923216,2000,9
42,2000-10-27,A Room for Romeo Brass,5250000,20097,20097,40194,-5209806,-0.992344,2000,10
42,2003-01-31,The R.M.,500000,1111615,1111615,2223230,1723230,3.44646,2003,1
42,2005-02-11,Inside Deep Throat,2000000,691880,691880,1383760,-616240,-0.30812,2005,2
42,2005-03-18,Ice Princess,25000000,24381334,25732334,50113668,25113668,1.00454672,2005,3
42,2005-08-12,The Skeleton Key,40000000,47907715,92256918,140164633,100164633,2.504115825,2005,8
42,2006-04-21,Silent Hill,50000000,46982632,94704227,141686859,91686859,1.83373718,2006,4
42,2006-08-25,The Quiet,900000,381420,381420,762840,-137160,-0.1524,2006,8
42,2006-09-22,Flyboys,60000000,13090630,14816379,27907009,-32092991,-0.5348831833333333,2006,9
42,2006-10-13,The Grudge 2,20000000,39143839,70743839,109887678,89887678,4.4943839,2006,10
42,2006-12-15,Dreamgirls,75000000,103365956,155708695,259074651,184074651,2.45432868,2006,12
42,2007-03-09,The Namesake,8500000,13610521,20288774,33899295,25399295,2.9881523529411766,2007,3
42,2007-10-19,"Gone, Baby, Gone",19000000,20300218,34352162,54652380,35652380,1.876441052631579,2007,10
42,2008-06-06,Kung Fu Panda,130000000,215434591,631910531,847345122,717345122,5.5180394,2008,6
42,2008-08-06,Bottle Shock,5000000,4078607,4815890,8894497,3894497,0.7788994,2008,8
42,2009-12-25,Sherlock Holmes,90000000,209028679,498438212,707466891,617466891,6.860743233333333,2009,12
42,2010-04-02,Tau ming chong,4000000,129078,38899792,39028870,35028870,8.7572175,2010,4
42,2010-05-21,MacGruber,10000000,8525600,8629895,17155495,7155495,0.7155495,2010,5
42,2010-09-03,San qiang pai an jing qi,12000000,190946,310946,501892,-11498108,-0.9581756666666666,2010,9
42,2010-12-22,Somewhere,7000000,1785645,17023121,18808766,11808766,1.6869665714285715,2010,12
42,2011-01-28,The Mechanic,42500000,29121498,76347393,105468891,62968891,1.4816209647058824,2011,1
42,2011-06-03,X-Men: First Class,160000000,146408305,355408305,501816610,341816610,2.1363538125,2011,6
42,2011-08-19,Nannerl la soeur de Mozart,4500000,707885,2404639,3112524,-1387476,-0.308328,2011,8
42,2011-10-21,Martha Marcy May Marlene,1000000,2981038,5438911,8419949,7419949,7.419949,2011,10
42,2012-02-10,The Vow,30000000,125014030,197618160,322632190,292632190,9.754406333333334,2012,2
42,2013-02-01,Bullet to the Head,55000000,9489829,22597969,32087798,-22912202,-0.4165854909090909,2013,2
42,2013-04-26,The Reluctant Fundamentalist,15000000,528731,528731,1057462,-13942538,-0.9295025333333333,2013,4
42,2014-01-10,The Legend of Hercules,70000000,18848538,58953319,77801857,7801857,0.1114551,2014,1
42,2014-02-28,The Lunchbox,1700000,4231500,12231500,16463000,14763000,8.684117647058823,2014,2
42,2014-04-04,Under the Skin,13300000,2614251,7229933,9844184,-3455816,-0.2598357894736842,2014,4
42,2014-06-13,Los insolitos peces gato,1300000,11278,54665,65943,-1234057,-0.9492746153846154,2014,6
42,2014-10-17,The Best of Me,26000000,26766213,41059418,67825631,41825631,1.6086781153846155,2014,10
42,2015-09-25,Hotel Transylvania 2,80000000,169700110,469500298,639200408,559200408,6.9900051,2015,9
42,2015-12-11,The Big Short,28000000,70259870,133162752,203422622,175422622,6.265093642857143,2015,12
42,2016-02-19,Mei Ren Yu,60720000,3229457,554516671,557746128,497026128,8.185542292490119,2016,2
42,2016-07-01,The Purge: Election Year,10000000,79042440,118514727,197557167,187557167,18.7557167,2016,7
42,2016-12-23,Silence,46500000,7100177,23726626,30826803,-15673197,-0.337058,2016,12
42,2018-02-16,Black Panther,200000000,700059566,1348258224,2048317790,1848317790,9.24158895,2018,2
42,2018-09-14,White Boy Rick,30000000,24004833,25947983,49952816,19952816,0.6650938666666667,2018,9
42,2019-06-14,Men in Black: International,110000000,3100000,3100000,6200000,-103800000,-0.9436363636363636,2019,6
43,1992-06-18,Batman Returns,80000000,162833635,266824291,429657926,349657926,4.370724075,1992,6
43,1993-06-30,The Firm,42000000,158340892,270340892,428681784,386681784,9.206709142857143,1993,6
43,1994-06-10,Speed,30000000,121248145,283200000,404448145,374448145,12.481604833333334,1994,6
43,1994-10-19,Clerks,27000,3073428,3894240,6967668,6940668,257.06177777777776,1994,10
43,1995-08-04,Virtuosity,30000000,23998226,23998226,47996452,17996452,0.5998817333333333,1995,8
43,1997-12-19,Titanic,200000000,659363944,-2086758901,-1427394957,-1627394957,-8.136974785,1997,12
43,1998-04-24,Sliding Doors,6000000,11911200,58809149,70720349,64720349,10.786724833333333,1998,4
43,1998-11-13,I Still Know What You Did Last Summer,24000000,40020622,40020622,80041244,56041244,2.3350518333333334,1998,11
43,1999-07-30,Twin Falls Idaho,500000,985341,1027228,2012569,1512569,3.025138,1999,7
43,1999-08-27,Dudley Do-Right,22000000,9818792,9818792,19637584,-2362416,-0.10738254545454545,1999,8
43,1999-09-17,Breakfast of Champions,12000000,178287,178287,356574,-11643426,-0.9702855,1999,9
43,1999-10-22,Three to Tango,20000000,10570375,10570375,21140750,1140750,0.0570375,1999,10
43,2000-07-26,Thomas and the Magic Railroad,19000000,15911332,15911332,31822664,12822664,0.6748770526315789,2000,7
43,2000-08-11,The Replacements,50000000,44737059,50054511,94791570,44791570,0.8958314,2000,8
43,2001-06-27,Baby Boy,16000000,28734552,28734552,57469104,41469104,2.591819,2001,6
43,2001-09-28,Dinner Rush,2000000,638227,1075504,1713731,-286269,-0.1431345,2001,9
43,2001-12-19,The Lord of the Rings: The Fellowship of the Ring,109000000,315544750,887210985,1202755735,1093755735,10.034456284403669,2001,12
43,2003-03-14,Spun,4500000,410241,1022649,1432890,-3067110,-0.68158,2003,3
43,2003-07-18,Dirty Pretty Things,10000000,8112414,14156753,22269167,12269167,1.2269167,2003,7
43,2003-09-26,Luther,35000000,5781086,32717063,38498149,3498149,0.09994711428571429,2003,9
43,2003-10-17,Pieces of April,300000,2528664,3571253,6099917,5799917,19.333056666666668,2003,10
43,2004-02-06,The Return,15000000,501752,5953886,6455638,-8544362,-0.5696241333333333,2004,2
43,2004-03-12,Agent Cody Banks 2: Destination London,26000000,23514247,28703083,52217330,26217330,1.0083588461538462,2004,3
43,2004-12-17,Mar adentro,13300000,2086345,39686345,41772690,28472690,2.140803759398496,2004,12
43,2004-12-22,Meet the Fockers,60000000,279167575,516567575,795735150,735735150,12.2622525,2004,12
43,2005-08-03,Junebug,1000000,2678010,3553253,6231263,5231263,5.231263,2005,8
43,2006-04-07,Simon,1300000,4055,1738663,1742718,442718,0.3405523076923077,2006,4
43,2006-09-22,All the King's Men,55000000,7221458,9521458,16742916,-38257084,-0.6955833454545455,2006,9
43,2007-04-27,Next,70000000,18211013,73591500,91802513,21802513,0.3114644714285714,2007,4
43,2008-11-07,Role Models,28000000,67300955,94500826,161801781,133801781,4.778635035714285,2008,11
43,2008-12-25,The Curious Case of Benjamin Button,160000000,127509326,329631958,457141284,297141284,1.857133025,2008,12
43,2009-01-16,Hotel for Dogs,35000000,73178547,122357172,195535719,160535719,4.586734828571428,2009,1
43,2009-07-01,Ice Age: Dawn of the Dinosaurs,90000000,196573705,859701857,1056275562,966275562,10.736395133333334,2009,7
43,2009-08-28,Halloween 2,15000000,33392973,38512850,71905823,56905823,3.793721533333333,2009,8
43,2010-10-01,Chain Letter,3000000,205842,1022453,1228295,-1771705,-0.5905683333333334,2010,10
43,2011-02-25,Des Hommes et Des Dieux,5000000,3954651,46263525,50218176,45218176,9.0436352,2011,2
43,2011-04-01,Trust,4000000,120016,120016,240032,-3759968,-0.939992,2011,4
43,2011-08-26,Don't Be Afraid of the Dark,25000000,24046682,39126427,63173109,38173109,1.52692436,2011,8
43,2011-09-23,Weekend,190000,484592,1577585,2062177,1872177,9.853563157894737,2011,9
43,2012-01-13,We Need to Talk About Kevin,7000000,1738692,10765283,12503975,5503975,0.7862821428571428,2012,1
43,2012-04-27,The Giant Mechanical Man,900000,7396,7396,14792,-885208,-0.9835644444444445,2012,4
43,2013-03-01,Phantom,18000000,1034589,1199510,2234099,-15765901,-0.8758833888888888,2013,3
43,2013-10-04,Grace Unplugged,1700000,2507159,2507159,5014318,3314318,1.9495988235294117,2013,10
43,2013-10-18,All is Lost,8500000,6263670,10386814,16650484,8150484,0.9588804705882353,2013,10
43,2013-11-01,Mr. Nobody,46500000,3622,22254,25876,-46474124,-0.9994435268817204,2013,11
43,2014-02-14,Winterâs Tale,60000000,12600231,29575033,42175264,-17824736,-0.29707893333333335,2014,2
43,2014-06-06,The Fault in Our Stars,12000000,124872350,307166834,432039184,420039184,35.00326533333333,2014,6
43,2014-06-20,Jersey Boys,40000000,47047013,65282732,112329745,72329745,1.808243625,2014,6
43,2014-10-10,Whiplash,3300000,13092006,38969037,52061043,48761043,14.776073636363636,2014,10
43,2015-07-17,Ant-Man,130000000,180202163,518858449,699060612,569060612,4.377389323076923,2015,7
43,2016-07-27,Nerve,20000000,38583626,70652284,109235910,89235910,4.4617955,2016,7
43,2018-05-18,Book Club,10000000,68566296,91113683,159679979,149679979,14.9679979,2018,5
43,2018-08-03,Christopher Robin,75000000,99215042,197504758,296719800,221719800,2.956264,2018,8
44,1944-08-01,Wilson,5200000,2000000,2000000,4000000,-1200000,-0.23076923076923078,1944,8
44,1962-11-08,Mutiny on The Bounty,19000000,13680000,13680000,27360000,8360000,0.44,1962,11
44,1982-05-14,Conan the Barbarian,20000000,38264085,79114085,117378170,97378170,4.8689085,1982,5
44,1982-08-27,Jekyll and Hyde... Together Again,5000000,3707583,3707583,7415166,2415166,0.4830332,1982,8
44,1989-12-15,We're No Angels,20000000,10555348,10555348,21110696,1110696,0.0555348,1989,12
44,1990-03-02,The Hunt for Red October,30000000,120709866,200500000,321209866,291209866,9.706995533333334,1990,3
44,1995-05-24,Tales from the Hood,6000000,11784569,11784569,23569138,17569138,2.9281896666666665,1995,5
44,1996-09-20,When The Cat's Away,300000,1652472,2525984,4178456,3878456,12.928186666666667,1996,9
44,1997-06-20,My Best Friend's Wedding,46000000,126813153,298923419,425736572,379736572,8.255142869565217,1997,6
44,1998-07-29,The Negotiator,50000000,44705766,49105766,93811532,43811532,0.87623064,1998,7
44,1998-09-18,One True Thing,30000000,23337196,26708196,50045392,20045392,0.6681797333333334,1998,9
44,1998-10-09,Holy Man,60000000,12069719,12069719,24139438,-35860562,-0.5976760333333333,1998,10
44,1999-01-22,Bacheha-Ye aseman,180000,933933,1628579,2562512,2382512,13.236177777777778,1999,1
44,1999-05-07,The Mummy,80000000,155385488,416385488,571770976,491770976,6.1471372,1999,5
44,1999-07-09,American Pie,12000000,101800948,234723148,336524096,324524096,27.043674666666668,1999,7
44,1999-07-23,Inspector Gadget,75000000,97387965,97387965,194775930,119775930,1.5970124,1999,7
44,1999-10-01,"Happy, Texas",1700000,2039192,2891228,4930420,3230420,1.9002470588235294,1999,10
44,1999-12-24,Pink Narcissus,27000,8231,8231,16462,-10538,-0.3902962962962963,1999,12
44,2000-08-25,Bring it On,10000000,68353550,90453550,158807100,148807100,14.88071,2000,8
44,2000-12-22,An Everlasting Piece,4000000,75078,75078,150156,-3849844,-0.962461,2000,12
44,2001-03-09,Company Man,12000000,146028,622273,768301,-11231699,-0.9359749166666667,2001,3
44,2001-04-11,Joe Dirt,16000000,27087695,30987695,58075390,42075390,2.629711875,2001,4
44,2001-08-03,Original Sin,26000000,16521410,16521410,33042820,7042820,0.2708776923076923,2001,8
44,2002-04-26,The Salton Sea,18000000,676698,676698,1353396,-16646604,-0.9248113333333333,2002,4
44,2002-09-20,Ballistic: Ecks vs. Sever,70000000,14294842,14294842,28589684,-41410316,-0.5915759428571429,2002,9
44,2003-07-25,Buffalo Soldiers,15000000,353743,353743,707486,-14292514,-0.9528342666666667,2003,7
44,2003-11-21,The Cat in the Hat,109000000,101018283,133818283,234836566,125836566,1.1544639082568808,2003,11
44,2004-02-27,Club Dread,8500000,5001655,7573551,12575206,4075206,0.479436,2004,2
44,2004-07-30,Thunderbirds,55000000,6768055,28231444,34999499,-20000501,-0.3636454727272727,2004,7
44,2004-08-20,Mean Creek,500000,603951,1348750,1952701,1452701,2.905402,2004,8
44,2005-03-25,Guess Who,35000000,68915888,102115888,171031776,136031776,3.8866221714285714,2005,3
44,2007-02-02,Factory Girl,7000000,1661464,1661464,3322928,-3677072,-0.525296,2007,2
44,2007-10-26,Bella,3300000,8093373,12405473,20498846,17198846,5.211771515151515,2007,10
44,2007-11-21,Hitman,24000000,39687694,99135571,138823265,114823265,4.784302708333334,2007,11
44,2008-05-02,Made of Honor,40000000,46012734,106548738,152561472,112561472,2.8140368,2008,5
44,2008-08-01,Frozen River,1000000,2511476,6030129,8541605,7541605,7.541605,2008,8
44,2009-03-13,The Last House on the Left,15000000,32752215,46526243,79278458,64278458,4.285230533333333,2009,3
44,2010-04-23,The Losers,25000000,23591432,29863840,53455272,28455272,1.13821088,2010,4
44,2010-07-14,The Sorcerer's Apprentice,160000000,63150991,217986320,281137311,121137311,0.75710819375,2010,7
44,2010-07-23,Life During Wartime,4500000,281447,281447,562894,-3937106,-0.8749124444444445,2010,7
44,2010-09-24,The Virginity Hit,2000000,636706,636706,1273412,-726588,-0.363294,2010,9
44,2011-01-28,Biutiful,35000000,5101237,24687524,29788761,-5211239,-0.14889254285714285,2011,1
44,2012-03-02,Tim and Eric's Billion Dollar Movie,3000000,201436,223652,425088,-2574912,-0.858304,2012,3
44,2012-03-16,21 Jump Street,42000000,138447667,202812429,341260096,299260096,7.1252403809523805,2012,3
44,2013-04-05,The Brass Teapot,900000,6997,413733,420730,-479270,-0.5325222222222222,2013,4
44,2014-02-07,The Lego Movie,60000000,257784718,457729388,715514106,655514106,10.9252351,2014,2
44,2014-03-14,Bad Words,10000000,7779614,7843145,15622759,5622759,0.5622759,2014,3
44,2014-09-12,No Good Deed,13200000,52543632,54323210,106866842,93666842,7.095972878787879,2014,9
44,2014-10-10,"Alexander and the Terrible, Horrible, No Good, Very Bad Day",28000000,66954149,101379287,168333436,140333436,5.011908428571428,2014,10
44,2015-03-27,Home,130000000,177397510,385997896,563395406,433395406,3.3338108153846155,2015,3
44,2017-12-08,Just Getting Started,22000000,6069605,6756412,12826017,-9173983,-0.41699922727272726,2017,12
44,2018-06-15,Incredibles 2,200000000,608581744,1242520711,1851102455,1651102455,8.255512275,2018,6
44,2018-12-14,Spider-Man: Into The Spider-Verse 3D,90000000,190173195,375381768,565554963,475554963,5.283944033333333,2018,12
45,1969-12-16,"Hello, Dolly",24000000,33208099,33208099,66416198,42416198,1.7673415833333332,1969,12
45,1987-12-23,Good Morning Vietnam,13000000,123922370,123922370,247844740,234844740,18.06498,1987,12
45,1989-10-13,Halloween 5: The Revenge of Michael Myers,6000000,11642254,11642254,23284508,17284508,2.8807513333333334,1989,10
45,1992-02-21,Radio Flyer,35000000,4651977,4651977,9303954,-25696046,-0.7341727428571428,1992,2
45,1996-12-06,Everyone Says I Love You,20000000,9725847,34600000,44325847,24325847,1.21629235,1996,12
45,1997-11-21,The Rainmaker,40000000,45916769,45916769,91833538,51833538,1.29583845,1997,11
45,1998-05-15,Clockwatchers,2000000,537948,539961,1077909,-922091,-0.4610455,1998,5
45,1998-08-14,How Stella Got Her Groove Back,20000000,37672944,37672944,75345888,55345888,2.7672944,1998,8
45,1999-03-26,Among Giants,4000000,64359,64359,128718,-3871282,-0.9678205,1999,3
45,1999-05-28,Notting Hill,42000000,116089678,363728085,479817763,437817763,10.424232452380952,1999,5
45,2000-07-21,What Lies Beneath,90000000,155464351,288693989,444158340,354158340,3.935092666666667,2000,7
45,2001-07-20,America's Sweethearts,46000000,93607673,160648493,254256166,208256166,4.52730795652174,2001,7
45,2001-08-10,Osmosis Jones,70000000,13596911,13596911,27193822,-42806178,-0.6115168285714285,2001,8
45,2001-09-21,Megiddo: Omega Code 2,22000000,6047691,6047691,12095382,-9904618,-0.4502099090909091,2001,9
45,2001-11-21,Sidewalks of New York,1000000,2402459,3575308,5977767,4977767,4.977767,2001,11
45,2001-12-25,Ali,109000000,58183966,87683966,145867932,36867932,0.3382379082568807,2001,12
45,2002-09-20,Sen to Chihiro no Kamikakushi,19000000,10049886,274949886,284999772,265999772,13.999988,2002,9
45,2003-01-17,Cidade de Deus,3300000,7563397,32059295,39622692,36322692,11.006876363636364,2003,1
45,2003-04-25,Steal (Canadian Release),15000000,220944,220944,441888,-14558112,-0.9705408,2003,4
45,2004-02-06,Miracle,28000000,64378093,64474705,128852798,100852798,3.601885642857143,2004,2
45,2004-11-26,Un long dimanche de fianÃ§ailles,55000000,6167817,69759296,75927113,20927113,0.38049296363636365,2004,11
45,2005-02-18,Because of Winn-Dixie,15000000,32647042,33508485,66155527,51155527,3.4103684666666667,2005,2
45,2005-08-05,Saint Ralph,5200000,795126,1695126,2490252,-2709748,-0.5211053846153846,2005,8
45,2006-05-04,Chinjeolhan geumjassi,4500000,211667,23471871,23683538,19183538,4.263008444444444,2006,5
45,2006-05-12,Poseidon,160000000,60674817,181674817,242349634,82349634,0.5146852125,2006,5
45,2006-05-19,Over the Hedge,80000000,155019340,343397247,498416587,418416587,5.2302073375,2006,5
45,2007-03-09,300,60000000,210614939,454161935,664776874,604776874,10.079614566666667,2007,3
45,2007-11-09,Holly,3000000,163069,163069,326138,-2673862,-0.8912873333333333,2007,11
45,2008-07-11,Meet Dave,60000000,11803254,50648806,62452060,2452060,0.04086766666666666,2008,7
45,2008-09-12,The Women,16000000,26902075,50103808,77005883,61005883,3.8128676875,2008,9
45,2008-12-10,Wendy and Lucy,300000,865695,1416046,2281741,1981741,6.605803333333333,2008,12
45,2009-04-24,The Informers,18000000,315000,315000,630000,-17370000,-0.965,2009,4
45,2009-04-24,Fighting,25000000,23091010,32831707,55922717,30922717,1.23690868,2009,4
45,2009-08-14,The Time Traveler's Wife,39000000,63414846,102332135,165746981,126746981,3.2499225897435897,2009,8
45,2009-09-17,Bright Star,8500000,4444637,17220091,21664728,13164728,1.5487915294117647,2009,9
45,2009-11-07,Nanjing! Nanjing!,12000000,122558,20122558,20245116,8245116,0.687093,2009,11
45,2011-02-04,Sanctum,30000000,23209310,108957098,132166408,102166408,3.4055469333333335,2011,2
45,2011-11-11,Immortals,75000000,83504017,211562435,295066452,220066452,2.93421936,2011,11
45,2012-04-20,Think Like a Man,12000000,91547205,113373764,204920969,192920969,16.076747416666667,2012,4
45,2012-04-27,The Raven,26000000,16008272,30601801,46610073,20610073,0.7926951153846153,2012,4
45,2012-12-21,This is 40,35000000,67544505,90221182,157765687,122765687,3.5075910571428572,2012,12
45,2013-08-16,Lee Daniels' The Butler,30000000,116632095,177025498,293657593,263657593,8.788586433333334,2013,8
45,2013-08-23,Drinking Buddies,500000,343706,407100,750806,250806,0.501612,2013,8
45,2013-11-15,The Christmas Candle,7000000,1632000,1933829,3565829,-3434171,-0.49059585714285714,2013,11
45,2015-02-27,Butterfly Girl,180000,17503,17503,35006,-144994,-0.8055222222222223,2015,2
45,2015-03-27,While We're Young,10000000,7582065,17503828,25085893,15085893,1.5085893,2015,3
45,2015-12-18,Saul fia,1700000,1777043,9696537,11473580,9773580,5.749164705882353,2015,12
45,2016-08-19,War Dogs,50000000,43034523,86234503,129269026,79269026,1.58538052,2016,8
45,2016-12-16,Rogue One: A Star Wars Story,200000000,532177324,1049102856,1581280180,1381280180,6.9064009,2016,12
45,2017-01-27,Emily,27000,3547,3547,7094,-19906,-0.7372592592592593,2017,1
45,2017-03-03,Table 19,5000000,3614896,4620399,8235295,3235295,0.647059,2017,3
45,2018-01-05,Insidious: The Last Key,10000000,67745330,167885588,235630918,225630918,22.5630918,2018,1
45,2018-12-19,Mary Poppins Returns,130000000,171958438,341528518,513486956,383486956,2.9498996615384616,2018,12
46,1970-01-01,Darling Lili,22000000,5000000,5000000,10000000,-12000000,-0.5454545454545454,1970,1
46,1972-06-30,Deep Throat,25000,45000000,45000000,90000000,89975000,3599.0,1972,6
46,1983-06-17,Superman III,39000000,59950623,59950623,119901246,80901246,2.074390923076923,1983,6
46,1985-11-06,Subway,2000000,390659,1663296,2053955,53955,0.0269775,1985,11
46,1991-07-19,Bill & Ted's Bogus Journey,20000000,37537675,37537675,75075350,55075350,2.7537675,1991,7
46,1992-02-07,Medicine Man,40000000,44948240,44948240,89896480,49896480,1.247412,1992,2
46,1993-04-16,Bound by Honor,35000000,4496583,4496583,8993166,-26006834,-0.7430524,1993,4
46,1994-05-25,Beverly Hills Cop III,50000000,42586861,119180938,161767799,111767799,2.23535598,1994,5
46,1996-11-22,Star Trek: First Contact,46000000,92027888,150000000,242027888,196027888,4.261475826086957,1996,11
46,1997-09-19,L.A. Confidential,35000000,64604977,126204977,190809954,155809954,4.451712971428571,1997,9
46,1998-02-13,Hurricane Streets,500000,334041,367582,701623,201623,0.403246,1998,2
46,1998-04-24,Two Girls and a Guy,1000000,2057193,2315026,4372219,3372219,3.372219,1998,4
46,1998-09-11,Let's Talk About Sex,300000,373615,373615,747230,447230,1.4907666666666666,1998,9
46,1999-01-29,She's All That,10000000,63465522,63465522,126931044,116931044,11.6931044,1999,1
46,1999-07-16,The Velocity of Gary,4000000,34145,34145,68290,-3931710,-0.9829275,1999,7
46,1999-09-24,One Man's Hero,18000000,229311,229311,458622,-17541378,-0.974521,1999,9
46,2000-04-07,Return to Me,24000000,32662299,32662299,65324598,41324598,1.72185825,2000,4
46,2000-05-05,Human Traffic,3300000,104257,5422740,5526997,2226997,0.6748475757575758,2000,5
46,2000-06-21,Chicken Run,42000000,106793915,227793915,334587830,292587830,6.966376904761905,2000,6
46,2000-09-29,Remember the Titans,30000000,115654751,136706683,252361434,222361434,7.4120478,2000,9
46,2001-09-21,Glitter,8500000,4273372,4273372,8546744,46744,0.005499294117647059,2001,9
46,2002-06-21,Lilo & Stitch,80000000,145771527,245800000,391571527,311571527,3.8946440875,2002,6
46,2004-02-20,Welcome to Mooseport,26000000,14469428,14469428,28938856,2938856,0.11303292307692307,2004,2
46,2004-06-18,The Terminal,75000000,77073959,218673959,295747918,220747918,2.9433055733333333,2004,6
46,2005-02-04,The Wedding Date,15000000,31726995,47175038,78902033,63902033,4.260135533333333,2005,2
46,2005-06-17,My Summer of Love,1700000,1000915,4727375,5728290,4028290,2.3695823529411766,2005,6
46,2005-08-12,The Great Raid,60000000,10166502,10597070,20763572,-39236428,-0.6539404666666667,2005,8
46,2006-07-21,My Super Ex-Girlfriend,30000000,22530295,60772856,83303151,53303151,1.7767717,2006,7
46,2007-03-02,Wild Hogs,60000000,168213584,253555383,421768967,361768967,6.029482783333333,2007,3
46,2007-04-20,Hot Fuzz,16000000,23618786,81742618,105361404,89361404,5.58508775,2007,4
46,2007-05-04,Lucky You,55000000,5755286,6521829,12277115,-42722885,-0.7767797272727273,2007,5
46,2007-08-24,War,25000000,22486409,40686409,63172818,38172818,1.52691272,2007,8
46,2007-08-31,Death Sentence,20000000,9534258,16907831,26442089,6442089,0.32210445,2007,8
46,2008-02-01,Over Her Dead Body,10000000,7570127,21596074,29166201,19166201,1.9166201,2008,2
46,2008-10-17,Sex Drive,19000000,8402485,10412485,18814970,-185030,-0.009738421052631578,2008,10
46,2009-09-25,I Hope They Serve Beer in Hell,7000000,1429299,1429453,2858752,-4141248,-0.5916068571428571,2009,9
46,2010-03-26,The Eclipse,3000000,133411,133411,266822,-2733178,-0.9110593333333333,2010,3
46,2010-08-27,Centurion,15000000,123570,7885048,8008618,-6991382,-0.4660921333333333,2010,8
46,2010-12-03,Black Swan,13000000,106954678,331266710,438221388,425221388,32.70933753846154,2010,12
46,2011-04-15,Rio,90000000,143619809,487519809,631139618,541139618,6.012662422222222,2011,4
46,2011-04-22,Dum Maaro Dum,5200000,564489,11633427,12197916,6997916,1.345753076923077,2011,4
46,2011-10-07,Blackthorn,4500000,200558,1217307,1417865,-3082135,-0.6849188888888889,2011,10
46,2011-10-28,Puss in Boots,130000000,149260504,554987477,704247981,574247981,4.4172921615384615,2011,10
46,2012-09-07,The Words,6000000,11494838,16369708,27864546,21864546,3.644091,2012,9
46,2013-01-28,Last Vegas,28000000,63914167,112914167,176828334,148828334,5.315297642857143,2013,1
46,2014-04-16,Heaven is for Real,12000000,91386097,100916299,192302396,180302396,15.025199666666667,2014,4
46,2014-05-09,Legends of Oz: Dorothyâs Return,70000000,8462347,20107933,28570280,-41429720,-0.5918531428571429,2014,5
46,2015-10-02,The Martian,108000000,228433663,655271443,883705106,775705106,7.182454685185185,2015,10
46,2015-10-09,Trash,12000000,17484,6553186,6570670,-5429330,-0.45244416666666665,2015,10
46,2016-04-15,Green Room,5000000,3220371,3807503,7027874,2027874,0.4055748,2016,4
46,2016-06-10,Warcraft,160000000,47225655,425522281,472747936,312747936,1.9546746,2016,6
46,2016-06-17,Finding Dory,200000000,486295561,1021215193,1507510754,1307510754,6.53755377,2016,6
47,1940-03-21,Rebecca,1288000,6000000,6002370,12002370,10714370,8.318610248447206,1940,3
47,1942-08-13,Bambi,858000,102797000,268000000,370797000,369939000,431.1643356643357,1942,8
47,1980-10-03,Somewhere in Time,5100000,9709597,9709597,19419194,14319194,2.8076850980392156,1980,10
47,1983-04-08,Losin' It,7000000,1246141,1246141,2492282,-4507718,-0.6439597142857143,1983,4
47,1986-08-08,She's Gotta Have It,175000,7137502,7137502,14275004,14100004,80.57145142857142,1986,8
47,1986-12-12,The Golden Child,12000000,79817937,79817937,159635874,147635874,12.3029895,1986,12
47,1987-09-25,The Princess Bride,15000000,30857000,30859628,61716628,46716628,3.1144418666666667,1987,9
47,1990-06-15,Gremlins 2: The New Batch,50000000,41476097,41476097,82952194,32952194,0.65904388,1990,6
47,1995-01-27,Highlander: The Final Dimension,26000000,13738574,13738574,27477148,1477148,0.05681338461538461,1995,1
47,1995-04-07,Don Juan DeMarco,25000000,22032635,22032635,44065270,19065270,0.7626108,1995,4
47,1997-08-01,In the Company of Men,25000,2883661,2883661,5767322,5742322,229.69288,1997,8
47,1997-12-12,Amistad,40000000,44212592,58250151,102462743,62462743,1.561568575,1997,12
47,1998-01-09,Firestorm,19000000,8123860,8123860,16247720,-2752280,-0.14485684210526314,1998,1
47,1998-05-08,Deep Impact,80000000,140464664,349464664,489929328,409929328,5.1241166,1998,5
47,1998-07-22,Lolita,55000000,1147784,1147784,2295568,-52704432,-0.9582624,1998,7
47,2000-09-29,The Broken Hearts Club: A Romantic Comedy,1000000,1744858,2022442,3767300,2767300,2.7673,2000,9
47,2001-01-12,Save the Last Dance,13000000,91038276,122244329,213282605,200282605,15.406354230769232,2001,1
47,2001-01-26,The Wedding Planner,28000000,60400856,94728529,155129385,127129385,4.5403351785714285,2001,1
47,2001-10-24,Bones,10000000,7316658,8378853,15695511,5695511,0.5695511,2001,10
47,2002-05-24,Insomnia,46000000,67263182,113622499,180885681,134885681,2.9322974130434782,2002,5
47,2002-07-12,Never Again,500000,307631,308793,616424,116424,0.232848,2002,7
47,2004-01-16,Along Came Polly,42000000,88073507,173044410,261117917,219117917,5.217093261904762,2004,1
47,2005-02-18,Constantine,75000000,75976178,221594911,297571089,222571089,2.96761452,2005,2
47,2005-04-15,House of D,2000000,388532,466106,854638,-1145362,-0.572681,2005,4
47,2005-06-24,Yes,1700000,396035,661221,1057256,-642744,-0.37808470588235293,2005,6
47,2005-07-29,Sky High,35000000,63939454,83109359,147048813,112048813,3.201394657142857,2005,7
47,2005-11-23,The Libertine,22000000,4835065,9448623,14283688,-7716312,-0.3507414545454545,2005,11
47,2006-08-25,Old Joy,300000,255923,399908,655831,355831,1.1861033333333333,2006,8
47,2006-10-06,The Departed,90000000,132384315,289660619,422044934,332044934,3.6893881555555557,2006,10
47,2006-10-13,Man of the Year,20000000,37442180,41342180,78784360,58784360,2.939218,2006,10
47,2006-12-29,The Dead Girl,3300000,19875,19875,39750,-3260250,-0.9879545454545454,2006,12
47,2007-02-02,Because I Said So,39000000,42674040,69538833,112212873,73212873,1.8772531538461539,2007,2
47,2007-10-26,Saw IV,10000000,63300095,135759694,199059789,189059789,18.9059789,2007,10
47,2008-03-21,The Grand,3000000,115879,115879,231758,-2768242,-0.9227473333333334,2008,3
47,2008-08-15,Vicky Cristina Barcelona,16000000,23216709,104504817,127721526,111721526,6.982595375,2008,8
47,2008-12-25,Marley & Me,60000000,143153751,247812011,390965762,330965762,5.5160960333333335,2008,12
47,2009-08-14,District 9,30000000,115646235,212453431,328099666,298099666,9.936655533333333,2009,8
47,2009-10-23,Ong-Bak 2,15000000,102458,7583050,7685508,-7314492,-0.4876328,2009,10
47,2009-11-06,The Men Who Stare at Goats,24000000,32428195,67348218,99776413,75776413,3.1573505416666667,2009,11
47,2010-06-18,Toy Story 3,200000000,415004880,1068879522,1483884402,1283884402,6.41942201,2010,6
47,2010-10-15,Carlos,18000000,145526,1619153,1764679,-16235321,-0.9019622777777778,2010,10
47,2010-11-05,Megamind,130000000,148415853,321887208,470303061,340303061,2.617715853846154,2010,11
47,2011-04-22,Stake Land,4000000,33245,679482,712727,-3287273,-0.82181825,2011,4
47,2011-08-19,5 Days of War,12000000,17479,87793,105272,-11894728,-0.9912273333333333,2011,8
47,2014-06-13,The Rover,8500000,1109199,3180252,4289451,-4210549,-0.4953587058823529,2014,6
47,2015-01-16,Blackhat,70000000,8005980,19665004,27670984,-42329016,-0.6047002285714286,2015,1
47,2015-05-08,Maggie,4500000,187112,1027760,1214872,-3285128,-0.7300284444444445,2015,5
47,2016-01-15,The Lady in the Van,6000000,10021175,42320503,52341678,46341678,7.723613,2016,1
47,2016-04-22,A Hologram for the King,35000000,4212494,11846010,16058504,-18941496,-0.5411856,2016,4
47,2016-06-03,Popstar: Never Stop Never Stopping,20000000,9496130,9537120,19033250,-966750,-0.0483375,2016,6
47,2016-09-30,Deepwater Horizon,156000000,61433527,122603824,184037351,28037351,0.17972660897435896,2016,9
47,2016-11-23,Allied,106000000,40098064,119266661,159364725,53364725,0.5034408018867924,2016,11
47,2017-02-24,Rock Dog,60000000,9420546,24148488,33569034,-26430966,-0.4405161,2017,2
47,2017-08-25,Ballerina,30000000,21858070,96892829,118750899,88750899,2.9583633,2017,8
47,2018-03-09,Thoroughbreds,5000000,3072605,3187302,6259907,1259907,0.2519814,2018,3
48,1956-11-19,Shichinin no samurai,500000,271736,271736,543472,43472,0.086944,1956,11
48,1981-04-30,Friday the 13th Part 2,1250000,21722776,21722776,43445552,42195552,33.7564416,1981,4
48,1982-06-04,Star Trek II: The Wrath of Khan,12000000,78912963,95800000,174712963,162712963,13.559413583333333,1982,6
48,1992-07-01,Boomerang,42000000,70052444,131052444,201104888,159104888,3.788211619047619,1992,7
48,1994-11-16,Heavenly Creatures,5000000,3046086,5438120,8484206,3484206,0.6968412,1994,11
48,1996-12-31,Silent Trigger,15000000,76382,76382,152764,-14847236,-0.9898157333333333,1996,12
48,1997-02-28,Smilla's Sense of Snow,35000000,2221994,2221994,4443988,-30556012,-0.8730289142857143,1997,2
48,1997-09-19,In & Out,35000000,63826569,83226569,147053138,112053138,3.2015182285714285,1997,9
48,1997-09-26,The Peacemaker,50000000,41263140,62967368,104230508,54230508,1.08461016,1997,9
48,1999-12-10,The Green Mile,60000000,136801374,290701374,427502748,367502748,6.1250458,1999,12
48,2000-01-14,The Terrorist,25000,195043,195043,390086,365086,14.60344,2000,1
48,2000-06-16,Boys and Girls,16000000,21799652,21799652,43599304,27599304,1.7249565,2000,6
48,2000-11-03,Charlie's Angels,90000000,125305545,259736090,385041635,295041635,3.278240388888889,2000,11
48,2002-04-19,My Big Fat Greek Wedding,5000000,241438208,374890034,616328242,611328242,122.2656484,2002,4
48,2002-07-12,Halloween: Resurrection,15000000,30259652,37659652,67919304,52919304,3.5279536,2002,7
48,2002-09-20,Eye See You,55000000,79161,1807990,1887151,-53112849,-0.9656881636363637,2002,9
48,2003-04-18,Lilja 4-ever,4500000,181655,4556982,4738637,238637,0.05303044444444444,2003,4
48,2003-07-18,Bad Boys II,130000000,138540870,273271982,411812852,281812852,2.167791169230769,2003,7
48,2004-03-19,Dawn of the Dead,28000000,58990765,103452875,162443640,134443640,4.801558571428571,2004,3
48,2004-04-23,Silmido,8500000,298347,30298347,30596694,22096694,2.5996110588235295,2004,4
48,2004-06-18,Dodgeball: A True Underdog Story,30000000,114326736,167791704,282118440,252118440,8.403948,2004,6
48,2004-07-16,"I, Robot",105000000,144801023,348629585,493430608,388430608,3.6993391238095237,2004,7
48,2004-09-17,Mr. 3000,30000000,21800302,21827296,43627598,13627598,0.45425326666666666,2004,9
48,2005-04-22,A Lot Like Love,25000000,21835784,41921590,63757374,38757374,1.55029496,2005,4
48,2005-07-15,First Morning,300000,87264,87264,174528,-125472,-0.41824,2005,7
48,2006-02-24,Madea's Family Reunion,10000000,63257940,63320521,126578461,116578461,11.6578461,2006,2
48,2006-03-17,Sommersturm,3000000,95204,95204,190408,-2809592,-0.9365306666666666,2006,3
48,2006-03-31,Basic Instinct 2,70000000,5946136,35417162,41363298,-28636702,-0.40909574285714284,2006,3
48,2006-06-28,Who Killed the Electric Car?,1000000,1678874,1849392,3528266,2528266,2.528266,2006,6
48,2006-07-21,Monster House,75000000,73661010,141267370,214928380,139928380,1.8657117333333333,2006,7
48,2006-09-22,Renaissance,18000000,70644,2401413,2472057,-15527943,-0.8626635,2006,9
48,2007-04-06,Zwartboek,22000000,4398532,27238354,31636886,9636886,0.43804027272727275,2007,4
48,2008-01-18,Teeth,2000000,347578,2350641,2698219,698219,0.3491095,2008,1
48,2008-10-31,Zack and Miri Make a Porno,24000000,31457946,36856306,68314252,44314252,1.8464271666666667,2008,10
48,2010-05-07,Mother and Child,7000000,1110509,6537179,7647688,647688,0.09252685714285715,2010,5
48,2010-12-10,The Chronicles of Narnia: The Voyage of the Dawn Treader,155000000,104386950,418186950,522573900,367573900,2.3714445161290323,2010,12
48,2011-02-11,Justin Bieber: Never Say Never,13000000,73013910,99034125,172048035,159048035,12.23446423076923,2011,2
48,2011-03-04,Take Me Home Tonight,19000000,6928068,7576604,14504672,-4495328,-0.2365962105263158,2011,3
48,2011-07-22,Another Earth,175000,1321194,2102779,3423973,3248973,18.56556,2011,7
48,2012-04-27,Bernie,6000000,9204489,10106975,19311464,13311464,2.218577333333333,2012,4
48,2012-06-22,Seeking a Friend for the End of the World,10000000,7078738,11766959,18845697,8845697,0.8845697,2012,6
48,2012-08-31,"For a Good Time, Call",850000,1251749,1386088,2637837,1787837,2.1033376470588236,2012,8
48,2012-10-05,Frankenweenie,39000000,35287788,81150788,116438576,77438576,1.9856045128205129,2012,10
48,2013-05-03,Iron Man 3,200000000,408992272,1215392272,1624384544,1424384544,7.12192272,2013,5
48,2013-07-12,Grown Ups 2,80000000,133668525,247023808,380692333,300692333,3.7586541625,2013,7
48,2013-09-20,Prisoners,46000000,61002302,113402302,174404604,128404604,2.7914044347826086,2013,9
48,2014-05-30,A Million Ways to Die in The West,40000000,42720965,86778557,129499522,89499522,2.23748805,2014,5
48,2015-01-23,Mortdecai,60000000,7696134,30396134,38092268,-21907732,-0.36512886666666666,2015,1
48,2015-02-27,Praia do Futuro,4000000,20620,760678,781298,-3218702,-0.8046755,2015,2
48,2015-07-10,Self/Less,26000000,12279691,33667319,45947010,19947010,0.7671926923076923,2015,7
48,2015-11-11,10 Days in a Madhouse,12000000,14616,14616,29232,-11970768,-0.997564,2015,11
48,2016-02-19,Risen,20000000,36880033,46255763,83135796,63135796,3.1567898,2016,2
48,2017-09-22,Friend Request,9900000,3759078,11310835,15069913,5169913,0.5222134343434344,2017,9
48,2017-10-27,Thank You for Your Service,20000000,9479390,9985316,19464706,-535294,-0.0267647,2017,10
49,1945-11-29,The Lost Weekend,1250000,11000000,11000000,22000000,20750000,16.6,1945,11
49,1953-08-05,From Here to Eternity,1650000,30500000,30500000,61000000,59350000,35.96969696969697,1953,8
49,1977-08-05,March or Die,7000000,1000000,1000000,2000000,-5000000,-0.7142857142857143,1977,8
49,1981-06-19,Superman II,54000000,108185706,108185706,216371412,162371412,3.006878,1981,6
49,1981-06-26,For Your Eyes Only,28000000,54800000,195300000,250100000,222100000,7.932142857142857,1981,6
49,1983-11-18,A Christmas Story,3250000,20605209,20605209,41210418,37960418,11.680128615384616,1983,11
49,1986-10-03,Playing for Keeps,35000000,2000000,2000000,4000000,-31000000,-0.8857142857142857,1986,10
49,1991-11-22,The Addams Family,30000000,113502246,191502246,305004492,275004492,9.1668164,1991,11
49,1996-03-29,Sgt. Bilko,39000000,30356589,37956589,68313178,29313178,0.7516199487179487,1996,3
49,1996-07-12,Courage Under Fire,46000000,59003384,100833145,159836529,113836529,2.474707152173913,1996,7
49,1996-07-26,Stonewall,2000000,304602,304602,609204,-1390796,-0.695398,1996,7
49,1998-05-01,He Got Game,25000000,21567853,22411948,43979801,18979801,0.75919204,1998,5
49,1998-06-05,The Truman Show,60000000,125618201,264118201,389736402,329736402,5.4956067,1998,6
49,1998-06-19,Mulan,90000000,120620254,303500000,424120254,334120254,3.7124472666666666,1998,6
49,1999-12-17,Stuart Little,105000000,140015224,298815224,438830448,333830448,3.1793376,1999,12
49,2000-12-08,Vertical Limit,75000000,68473360,213500000,281973360,206973360,2.7596448,2000,12
49,2000-12-15,Pollock,6000000,8596914,10557291,19154205,13154205,2.1923675,2000,12
49,2001-01-12,Double Take,24000000,29823162,29823162,59646324,35646324,1.4852635,2001,1
49,2001-08-24,The Curse of the Jade Scorpion,26000000,7496522,18496522,25993044,-6956,-0.00026753846153846153,2001,8
49,2002-09-13,Barbershop,12000000,75781642,77063461,152845103,140845103,11.737091916666667,2002,9
49,2002-12-27,Sonny,4000000,17639,17639,35278,-3964722,-0.9911805,2002,12
49,2003-08-29,Civil Brand,500000,254293,254293,508586,8586,0.017172,2003,8
49,2003-10-03,Out of Time,50000000,41083108,55489826,96572934,46572934,0.93145868,2003,10
49,2004-01-30,Latter Days,850000,833118,865708,1698826,848826,0.9986188235294118,2004,1
49,2005-01-07,White Noise,10000000,56094360,92094360,148188720,138188720,13.818872,2005,1
49,2006-01-27,Imagine Me & You,7900000,672243,3129471,3801714,-4098286,-0.5187703797468355,2006,1
49,2006-12-01,Turistas,10000000,7027762,14321070,21348832,11348832,1.1348832,2006,12
49,2007-06-15,Pierrot le fou,300000,70807,71380,142187,-157813,-0.5260433333333333,2007,6
49,2007-12-25,The Great Debaters,15000000,30226144,30261293,60487437,45487437,3.0324958,2007,12
49,2008-01-11,In the Name of the King: A Dungeon Siege Tale,60000000,4775656,13233220,18008876,-41991124,-0.6998520666666667,2008,1
49,2008-08-01,Midnight Meat Train,15000000,73548,1590246,1663794,-13336206,-0.8890804,2008,8
49,2008-11-07,Repo! The Genetic Opera,8500000,140244,198883,339127,-8160873,-0.9601027058823529,2008,11
49,2009-07-10,BrÃ¼no,42000000,60054530,138708527,198763057,156763057,3.7324537380952383,2009,7
49,2009-09-18,The Secrets of Jonathan Sperry,1000000,1355079,1355079,2710158,1710158,1.710158,2009,9
49,2009-12-04,Everybody's Fine,20000000,9208876,9208876,18417752,-1582248,-0.0791124,2009,12
49,2010-04-09,After.Life,4500000,108596,2481925,2590521,-1909479,-0.4243286666666667,2010,4
49,2010-04-30,Gunless,9900000,458054,458054,916108,-8983892,-0.9074638383838384,2010,4
49,2010-04-30,A Nightmare on Elm Street,35000000,63075011,117729621,180804632,145804632,4.165846628571429,2010,4
49,2010-05-28,Agora,70000000,619423,38992292,39611715,-30388285,-0.4341183571428571,2010,5
49,2010-08-18,Vampires Suck,20000000,36661504,81424988,118086492,98086492,4.9043246,2010,8
49,2010-11-19,The Next Three Days,30000000,21148651,67255916,88404567,58404567,1.9468189,2010,11
49,2011-08-12,Final Destination 5,40000000,42587643,155011165,197598808,157598808,3.9399702,2011,8
49,2011-12-16,Alvin and the Chipmunks: Chipwrecked,80000000,133107389,349088523,482195912,402195912,5.0274489,2011,12
49,2012-09-28,Won't Back Down,19000000,5310554,5745503,11056057,-7943943,-0.4181022631578947,2012,9
49,2013-08-23,Sparrows Dance,175000,2602,2602,5204,-169796,-0.9702628571428571,2013,8
49,2014-04-11,Rio 2,130000000,131538435,492846291,624384726,494384726,3.802959430769231,2014,4
49,2014-08-15,Fort McCoy,3000000,78948,78948,157896,-2842104,-0.947368,2014,8
49,2014-10-31,Before I Go to Sleep,22000000,3242457,19563579,22806036,806036,0.036638,2014,10
49,2015-07-01,Terminator: Genisys,155000000,89760956,432150894,521911850,366911850,2.3671732258064515,2015,7
49,2016-03-04,The Other Side of the Door,5000000,3000342,12905107,15905449,10905449,2.1810898,2016,3
49,2017-02-24,Get Out,5000000,176040665,255367951,431408616,426408616,85.2817232,2017,2
49,2017-05-05,Guardians of the Galaxy Vol 2,200000000,389813101,862316233,1252129334,1052129334,5.26064667,2017,5
49,2018-06-13,Superfly,16000000,20537137,20723581,41260718,25260718,1.578794875,2018,6
49,2018-07-04,The First Purge,13000000,69488745,136617305,206106050,193106050,14.854311538461538,2018,7
50,1938-09-01,You Can't Take It With You,1644000,4000000,4000000,8000000,6356000,3.8661800486618003,1938,9
50,1963-06-12,Cleopatra,42000000,57000000,71000000,128000000,86000000,2.0476190476190474,1963,6
50,1979-12-21,The Black Hole,20000000,35841901,35841901,71683802,51683802,2.5841901,1979,12
50,1980-01-01,Lion of the Desert,35000000,1500000,1500000,3000000,-32000000,-0.9142857142857143,1980,1
50,1982-08-20,Class of 1984,3250000,6965361,6965361,13930722,10680722,3.286376,1982,8
50,1982-09-17,Inchon,46000000,4408636,4408636,8817272,-37182728,-0.8083201739130434,1982,9
50,1983-06-03,WarGames,12000000,74433837,74433837,148867674,136867674,11.4056395,1983,6
50,1984-08-31,C.H.U.D.,1250000,4700000,4700000,9400000,8150000,6.52,1984,8
50,1986-10-17,The Color of Money,10000000,52293000,52293000,104586000,94586000,9.4586,1986,10
50,1994-11-18,LÃ©on,16000000,19284974,45284974,64569948,48569948,3.03562175,1994,11
50,1995-11-10,Ace Ventura: When Nature Calls,30000000,108360063,212400000,320760063,290760063,9.6920021,1995,11
50,1996-07-12,Les Visiteurs,7000000,659000,98754000,99413000,92413000,13.201857142857143,1996,7
50,1996-07-17,Walking and Talking,1000000,1287480,1615787,2903267,1903267,1.903267,1996,7
50,1997-03-05,The Watermelon Woman,300000,42735,42735,85470,-214530,-0.7151,1997,3
50,1997-06-20,The Last Time I Committed Suicide,4000000,12836,12836,25672,-3974328,-0.993582,1997,6
50,1999-08-04,The Gambler,3000000,51773,101773,153546,-2846454,-0.948818,1999,8
50,1999-12-21,"Girl, Interrupted",24000000,28871190,28871190,57742380,33742380,1.4059325,1999,12
50,2000-08-18,The Cell,35000000,61280963,85911226,147192189,112192189,3.205491114285714,2000,8
50,2002-02-22,Mean Machine,4500000,92723,92723,185446,-4314554,-0.9587897777777777,2002,2
50,2002-03-22,Blade 2,54000000,81676888,154338601,236015489,182015489,3.3706572037037037,2002,3
50,2003-07-04,Swimming Pool,7800000,10130108,24021282,34151390,26351390,3.3783833333333333,2003,7
50,2003-10-24,Beyond Borders,60000000,4426297,11427090,15853387,-44146613,-0.7357768833333334,2003,10
50,2004-06-30,Spider-Man 2,200000000,373524485,795110670,1168635155,968635155,4.843175775,2004,6
50,2004-08-27,Superbabies: Baby Geniuses 2,20000000,9109322,9355369,18464691,-1535309,-0.07676545,2004,8
50,2004-11-12,Bridget Jones: The Edge Of Reason,50000000,40203020,263894551,304097571,254097571,5.08195142,2004,11
50,2005-09-30,Serenity,39000000,25514517,40319440,65833957,26833957,0.6880501794871795,2005,9
50,2006-09-08,Sherrybaby,2000000,199176,759504,958680,-1041320,-0.52066,2006,9
50,2007-12-21,Charlie Wilson's War,75000000,66661095,119512771,186173866,111173866,1.4823182133333332,2007,12
50,2008-02-15,Dolphins and Whales Tribes of the Ocean 3D,6000000,7714996,17252287,24967283,18967283,3.1612138333333335,2008,2
50,2008-03-21,The Hammer,850000,442638,442638,885276,35276,0.041501176470588236,2008,3
50,2008-06-20,Get Smart,80000000,130319208,226739416,357058624,277058624,3.4632328,2008,6
50,2008-08-13,Tropic Thunder,90000000,110515313,191145256,301660569,211660569,2.3517841,2008,8
50,2009-04-03,Adventureland,9800000,16044025,17553055,33597080,23797080,2.4282734693877552,2009,4
50,2009-11-25,The Princess and the Frog,105000000,104400899,270997378,375398277,270398277,2.575221685714286,2009,11
50,2010-07-09,Despicable Me,69000000,251513985,543464573,794978558,725978558,10.521428376811594,2010,7
50,2010-07-23,Salt,130000000,118311368,290650494,408961862,278961862,2.145860476923077,2010,7
50,2010-10-08,Stone,22000000,1810078,4065020,5875098,-16124902,-0.7329500909090909,2010,10
50,2010-10-29,Monsters,500000,237301,5639730,5877031,5377031,10.754062,2010,10
50,2011-02-11,The Eagle,25000000,19490041,38993548,58483589,33483589,1.33934356,2011,2
50,2011-05-13,Everything Must Go,5000000,2712131,2821010,5533141,533141,0.1066282,2011,5
50,2013-09-06,Winnie Mandela,15000000,61847,61847,123694,-14876306,-0.9917537333333334,2013,9
50,2013-10-18,The Fifth Estate,26000000,3254172,6154172,9408344,-16591656,-0.6381406153846154,2013,10
50,2014-08-22,When the Game Stands Tall,15000000,30127963,30138912,60266875,45266875,3.0177916666666667,2014,8
50,2016-03-16,Miracles from Heaven,13000000,61705123,73798736,135503859,122503859,9.42337376923077,2016,3
50,2016-09-09,Sully,60000000,125070033,238524556,363594589,303594589,5.059909816666667,2016,9
50,2016-11-11,Shut In,10000000,6900335,11360665,18261000,8261000,0.8261,2016,11
50,2017-01-20,Split,5000000,138141585,278964806,417106391,412106391,82.4212782,2017,1
50,2018-01-12,Proud Mary,30000000,20868638,21709539,42578177,12578177,0.4192725666666667,2018,1
50,2018-03-23,Pacific Rim: Uprising,155000000,59874525,290930148,350804673,195804673,1.2632559548387097,2018,3
50,2018-06-01,Action Point,19000000,5059608,5103675,10163283,-8836717,-0.4650903684210526,2018,6
50,2018-06-15,Tag,28000000,54730625,77026186,131756811,103756811,3.705600392857143,2018,6
50,2018-11-16,Widows,40000000,42402632,73866088,116268720,76268720,1.906718,2018,11
51,1964-01-01,The Fall of the Roman Empire,19000000,4750000,4750000,9500000,-9500000,-0.5,1964,1
51,1981-06-12,Clash of the Titans,15000000,30000000,44400000,74400000,59400000,3.96,1981,6
51,1990-02-23,The Blood of Heroes,7700000,882290,882290,1764580,-5935420,-0.7708337662337662,1990,2
51,1994-02-04,Ace Ventura: Pet Detective,12000000,72217396,107217396,179434792,167434792,13.952899333333333,1994,2
51,1995-07-07,Species,35000000,60054449,113354449,173408898,138408898,3.954539942857143,1995,7
51,1996-04-19,Le hussard sur le toit,35000000,1320043,1320043,2640086,-32359914,-0.9245689714285714,1996,4
51,1997-02-21,Blood and Wine,26000000,1083350,1083350,2166700,-23833300,-0.9166653846153846,1997,2
51,1999-02-26,200 Cigarettes,6000000,6852450,6852450,13704900,7704900,1.28415,1999,2
51,1999-04-09,Foolish,1600000,6026908,6026908,12053816,10453816,6.533635,1999,4
51,1999-04-16,Life,75000000,64062587,73521587,137584174,62584174,0.8344556533333334,1999,4
51,2000-02-11,Snow Day,13000000,60008303,62452927,122461230,109461230,8.420094615384615,2000,2
51,2000-02-11,The Beach,50000000,39778599,39778599,79557198,29557198,0.59114396,2000,2
51,2000-09-08,Nurse Betty,24000000,25170054,27732366,52902420,28902420,1.2042675,2000,9
51,2000-10-13,Just Looking,3000000,39852,39852,79704,-2920296,-0.973432,2000,10
51,2001-08-03,The Princess Diaries,30000000,108244774,165334774,273579548,243579548,8.119318266666667,2001,8
51,2001-12-14,The Royal Tenenbaums,28000000,52353636,71430876,123784512,95784512,3.4208754285714287,2001,12
51,2002-06-14,The Bourne Identity,60000000,121468960,214357371,335826331,275826331,4.597105516666667,2002,6
51,2003-09-19,Bubba Ho-Tep,1000000,1239183,1492895,2732078,1732078,1.732078,2003,9
51,2004-08-06,Little Black Book,30000000,20422207,21758371,42180578,12180578,0.40601926666666666,2004,8
51,2004-11-24,Alexander,155000000,34297191,167297191,201594382,46594382,0.30060891612903223,2004,11
51,2005-03-11,Robots,80000000,128200012,260700012,388900024,308900024,3.8612503,2005,3
51,2005-04-08,Fever Pitch,40000000,42071069,50071069,92142138,52142138,1.30355345,2005,4
51,2006-03-03,Joyeux NoÃ«l,22000000,1054361,23134075,24188436,2188436,0.09947436363636364,2006,3
51,2006-03-24,Lonesome Jim,500000,154187,602789,756976,256976,0.513952,2006,3
51,2006-07-14,"You, Me and Dupree",54000000,75802010,130402010,206204020,152204020,2.818592962962963,2006,7
51,2007-08-31,Fong juk,4500000,51957,51957,103914,-4396086,-0.976908,2007,8
51,2007-09-07,Shoot 'Em Up,39000000,12796824,26796824,39593648,593648,0.01522174358974359,2007,9
51,2008-03-07,"10,000 B.C.",105000000,94784201,269065678,363849879,258849879,2.465236942857143,2008,3
51,2009-01-30,Entre les murs,3250000,3766810,34114067,37880877,34630877,10.655654461538461,2009,1
51,2010-03-05,Alice in Wonderland,200000000,334191110,1025491110,1359682220,1159682220,5.7984111,2010,3
51,2010-03-12,Remember Me,16000000,19068240,56506120,75574360,59574360,3.7233975,2010,3
51,2010-07-30,Dinner for Schmucks,69000000,73026337,86796502,159822839,90822839,1.3162730289855074,2010,7
51,2010-09-01,The American,20000000,35606376,67950723,103557099,83557099,4.17785495,2010,9
51,2010-12-31,Arthur and the War of Two Worlds,45500000,347136,36180824,36527960,-8972040,-0.1971876923076923,2010,12
51,2011-02-11,Cedar Rapids,10000000,6861102,7862131,14723233,4723233,0.4723233,2011,2
51,2011-03-11,3 Backyards,300000,39475,39475,78950,-221050,-0.7368333333333333,2011,3
51,2011-10-21,Paranormal Activity 3,5000000,104028807,207039844,311068651,306068651,61.2137302,2011,10
51,2011-11-04,The Son of No One,15000000,30680,1148578,1179258,-13820742,-0.9213828,2011,11
51,2011-12-20,The Girl with the Dragon Tattoo,90000000,102515793,239373970,341889763,251889763,2.7987751444444444,2011,12
51,2012-12-19,Amour,9700000,6738954,36787044,43525998,33825998,3.487216288659794,2012,12
51,2013-09-20,Battle of the Year,20000000,8888355,16723377,25611732,5611732,0.2805866,2013,9
51,2014-03-28,Noah,130000000,101200044,352831065,454031109,324031109,2.4925469923076924,2014,3
51,2014-04-18,13 Sins,4000000,9134,47552,56686,-3943314,-0.9858285,2014,4
51,2014-10-10,Kill the Messenger,5000000,2450846,6656705,9107551,4107551,0.8215102,2014,10
51,2014-10-17,Dear White People,1250000,4404154,5403771,9807925,8557925,6.84634,2014,10
51,2015-02-13,The Last Five Years,2000000,147299,205298,352597,-1647403,-0.8237015,2015,2
51,2015-06-05,Insidious Chapter 3,10000000,52218558,120453155,172671713,162671713,16.2671713,2015,6
51,2015-08-05,Shaun the Sheep,25000000,19375982,101925161,121301143,96301143,3.85204572,2015,8
51,2015-08-28,Windsor Drive,850000,3256,3256,6512,-843488,-0.9923388235294117,2015,8
51,2015-10-02,Freeheld,7000000,546201,1732228,2278429,-4721571,-0.6745101428571428,2015,10
51,2016-02-05,Xi You Ji zhi Sun Wu Kong San Da Bai Gu Jing,60000000,709982,194058503,194768485,134768485,2.2461414166666667,2016,2
51,2016-06-03,The Fits,170000,166425,169242,335667,165667,0.9745117647058823,2016,6
51,2017-05-12,Snatched,42000000,45852178,57852177,103704355,61704355,1.4691513095238096,2017,5
52,1949-07-26,She Wore a Yellow Ribbon,1600000,5400000,5400000,10800000,9200000,5.75,1949,7
52,1979-06-30,Dolphin,170000,14000,14000,28000,-142000,-0.8352941176470589,1979,6
52,1992-10-02,The Mighty Ducks,10000000,50752337,50752337,101504674,91504674,9.1504674,1992,10
52,1993-11-24,The Nutcracker,19000000,2119994,2119994,4239988,-14760012,-0.7768427368421053,1993,11
52,1997-03-21,Selena,20000000,35450113,35450113,70900226,50900226,2.5450113,1997,3
52,1997-03-21,Liar Liar,45000000,181410615,302710615,484121230,439121230,9.758249555555556,1997,3
52,1997-07-11,Contact,90000000,100920329,165900000,266820329,176820329,1.9646703222222222,1997,7
52,1998-09-18,Six-String Samurai,2000000,134624,134624,269248,-1730752,-0.865376,1998,9
52,1999-03-05,Analyze This,30000000,106885658,176885658,283771316,253771316,8.459043866666667,1999,3
52,1999-10-29,Dreaming of Joseph Lees,3250000,7680,7680,15360,-3234640,-0.9952738461538462,1999,10
52,1999-11-24,Ride With the Devil,35000000,630779,630779,1261558,-33738442,-0.9639554857142857,1999,11
52,2001-12-07,No Man's Land,1000000,1067481,2684207,3751688,2751688,2.751688,2001,12
52,2002-10-11,White Oleander,16000000,16357770,21657770,38015540,22015540,1.37597125,2002,10
52,2002-10-25,All the Queen's Men,15000000,22723,22723,45446,-14954554,-0.9969702666666667,2002,10
52,2003-04-25,Identity,28000000,52131264,82183683,134314947,106314947,3.796962392857143,2003,4
52,2004-01-23,The Butterfly Effect,13000000,57924679,95638592,153563271,140563271,10.812559307692307,2004,1
52,2004-02-20,Confessions of a Teenage Drama Queen,15000000,29331068,33118854,62449922,47449922,3.163328133333333,2004,2
52,2004-02-20,Against the Ropes,39000000,5881504,6429865,12311369,-26688631,-0.6843238717948718,2004,2
52,2005-01-19,Assault On Precinct 13,30000000,20040895,36040895,56081790,26081790,0.869393,2005,1
52,2005-03-04,Be Cool,75000000,55849401,94944017,150793418,75793418,1.0105789066666666,2005,3
52,2005-06-10,The Adventures of Sharkboy and Lavagirl in 3-D,50000000,39177684,69425966,108603650,58603650,1.172073,2005,6
52,2005-10-28,Saw II,5000000,87025093,152925093,239950186,234950186,46.9900372,2005,10
52,2006-04-07,The Benchwarmers,35000000,59843754,65063726,124907480,89907480,2.5687851428571427,2006,4
52,2006-04-12,Sisters in Law,300000,33312,33312,66624,-233376,-0.77792,2006,4
52,2006-04-28,The Lost City,9600000,2484186,5256839,7741025,-1858975,-0.19364322916666668,2006,4
52,2007-12-25,Aliens vs. Predator - Requiem,40000000,41797066,128884494,170681560,130681560,3.267039,2007,12
52,2008-12-19,Seven Pounds,54000000,69951824,166617328,236569152,182569152,3.380910222222222,2008,12
52,2009-10-09,Couples Retreat,60000000,109205660,172450423,281656083,221656083,3.69426805,2009,10
52,2010-02-12,My Name is Khan,8470000,4046336,42355526,46401862,37931862,4.478378040141677,2010,2
52,2010-02-19,Shutter Island,80000000,128012934,299461782,427474716,347474716,4.34343395,2010,2
52,2010-03-19,City Island,6000000,6671283,8173486,14844769,8844769,1.4741281666666666,2010,3
52,2010-07-23,Spoken Word,4500000,32961,32961,65922,-4434078,-0.9853506666666667,2010,7
52,2010-08-20,Piranha 3D,24000000,25003155,83660160,108663315,84663315,3.527638125,2010,8
52,2010-12-17,Rabbit Hole,5000000,2229058,6205034,8434092,3434092,0.6868184,2010,12
52,2011-05-13,Go For It!,2450000,180237,182358,362595,-2087405,-0.8520020408163266,2011,5
52,2011-09-02,Shark Night 3D,25000000,18877153,18877153,37754306,12754306,0.51017224,2011,9
52,2011-11-18,Another Happy Day,4000000,9120,978527,987647,-3012353,-0.75308825,2011,11
52,2011-12-21,The Adventures of Tintin,130000000,77591831,373993951,451585782,321585782,2.473736784615385,2011,12
52,2012-02-24,Act of Valor,12000000,70012847,82497035,152509882,140509882,11.709156833333333,2012,2
52,2012-10-12,Here Comes the Boom,42000000,45290318,73239258,118529576,76529576,1.8221327619047618,2012,10
52,2012-11-08,Skyfall,200000000,304360277,1110526981,1414887258,1214887258,6.07443629,2012,11
52,2012-11-30,The Collection,10000000,6810754,8890094,15700848,5700848,0.5700848,2012,11
52,2013-04-17,Deceptive Practice: The Mysteries and Mentors of Ricky Jay,500000,152449,152449,304898,-195102,-0.390204,2013,4
52,2013-04-19,Filly Brown,1250000,2850357,2940411,5790768,4540768,3.6326144,2013,4
52,2014-03-21,Blood Ties,26000000,42472,2923959,2966431,-23033569,-0.8859065,2014,3
52,2014-04-02,Dom Hemingway,7000000,523511,1857458,2380969,-4619031,-0.6598615714285714,2014,4
52,2015-04-14,Loin des hommes,7700000,5336,1080428,1085764,-6614236,-0.8589916883116883,2015,4
52,2015-09-04,Before We Go,3000000,37151,483938,521089,-2478911,-0.8263036666666667,2015,9
52,2016-04-29,Ratchet and Clank,20000000,8813410,14365639,23179049,3179049,0.15895245,2016,4
52,2016-07-22,Ice Age: Collision Course,105000000,64063008,402156682,466219690,361219690,3.4401875238095236,2016,7
52,2017-07-14,War for the Planet of the Apes,152000000,146880162,489592267,636472429,484472429,3.1873186118421053,2017,7
52,2018-03-02,Red Sparrow,69000000,46874505,145951861,192826366,123826366,1.7945850144927535,2018,3
53,1953-01-21,Niagara,1250000,2500000,2500000,5000000,3750000,3.0,1953,1
53,1968-06-12,Rosemary's Baby,3200000,33395426,33395426,66790852,63590852,19.87214125,1968,6
53,1974-04-07,The Conversation,1600000,4420000,4420000,8840000,7240000,4.525,1974,4
53,1974-12-11,The Godfather: Part II,13000000,57300000,57300000,114600000,101600000,7.815384615384615,1974,12
53,1977-06-24,Sorcerer,21600000,12000000,12005968,24005968,2405968,0.11138740740740741,1977,6
53,1985-02-08,Witness,12000000,65532576,65532576,131065152,119065152,9.922096,1985,2
53,1989-12-13,Driving Miss Daisy,7500000,106593296,106593296,213186592,205686592,27.424878933333332,1989,12
53,1990-12-25,The Godfather: Part III,54000000,66520529,66520529,133041058,79041058,1.4637232962962963,1990,12
53,1991-08-01,Slacker,23000,1227508,1227508,2455016,2432016,105.73982608695653,1991,8
53,1994-02-18,On Deadly Ground,50000000,38590458,38590458,77180916,27180916,0.54361832,1994,2
53,1995-11-17,Goldeneye,60000000,106429941,356429941,462859882,402859882,6.714331366666666,1995,11
53,1996-09-20,The First Wives Club,30000000,105489203,181489203,286978406,256978406,8.565946866666666,1996,9
53,1996-10-16,Get on the Bus,2400000,5691854,5691854,11383708,8983708,3.743211666666667,1996,10
53,1997-08-24,The Grimm Brothers' Snow White,26000000,5000,5000,10000,-25990000,-0.9996153846153846,1997,8
53,1998-04-17,The Object of my Affection,15000000,29145924,29145924,58291848,43291848,2.8861232,1998,4
53,1998-10-09,Slam,1000000,1009819,1087521,2097340,1097340,1.09734,1998,10
53,1998-10-30,American History X,10000000,6719864,6719864,13439728,3439728,0.3439728,1998,10
53,1998-11-20,A Bug's Life,45000000,162798565,363095319,525893884,480893884,10.686530755555555,1998,11
53,2000-01-12,Next Friday,9500000,57176582,59675307,116851889,107351889,11.300198842105264,2000,1
53,2000-05-26,Hum to Mohabbt Karega,2000000,121807,121807,243614,-1756386,-0.878193,2000,5
53,2001-04-27,Town & Country,105000000,6712451,10364769,17077220,-87922780,-0.8373598095238095,2001,4
53,2001-05-25,Pearl Harbor,151500000,198539855,449239855,647779710,496279710,3.2757736633663366,2001,5
53,2001-10-05,Serendipity,28000000,50255310,77477297,127732607,99732607,3.5618788214285715,2001,10
53,2002-04-05,High Crimes,42000000,41543207,63781100,105324307,63324307,1.5077215952380953,2002,4
53,2003-12-12,Something's Gotta Give,80000000,124685242,266685242,391370484,311370484,3.89213105,2003,12
53,2005-12-23,Munich,75000000,47379090,131492772,178871862,103871862,1.38495816,2005,12
53,2007-03-23,Namastey London,8400000,1207007,6831069,8038076,-361924,-0.04308619047619048,2007,3
53,2007-08-17,Death at a Funeral,20000000,8580428,46790428,55370856,35370856,1.7685428,2007,8
53,2007-10-05,The Good Night,15000000,22441,22441,44882,-14955118,-0.9970078666666666,2007,10
53,2007-12-25,The Water Horse: Legend of the Deep,40000000,40412817,103429755,143842572,103842572,2.5960643,2007,12
53,2008-06-06,You Don't Mess With the Zohan,90000000,100018837,202910991,302929828,212929828,2.3658869777777776,2008,6
53,2009-09-18,Jennifer's Body,16000000,16204793,31943401,48148194,32148194,2.009262125,2009,9
53,2010-06-30,The Twilight Saga: Eclipse,68000000,300531751,706102828,1006634579,938634579,13.803449691176471,2010,6
53,2010-07-30,The Extra Man,7000000,453377,492108,945485,-6054515,-0.8649307142857143,2010,7
53,2010-10-08,Secretariat,35000000,59699513,60376247,120075760,85075760,2.430736,2010,10
53,2010-11-24,Faster,24000000,23240020,35792945,59032965,35032965,1.459706875,2010,11
53,2011-11-04,A Very Harold & Kumar 3D Christmas,20000000,35061031,36265745,71326776,51326776,2.5663388,2011,11
53,2011-12-13,George Balanchine\'s The Nutcracker,19000000,2119994,2119994,4239988,-14760012,-0.7768427368421053,2011,12
53,2012-01-13,The Divide,3000000,18000,156362,174362,-2825638,-0.9418793333333333,2012,1
53,2012-03-16,Casa de mi Padre,6000000,5909483,8446952,14356435,8356435,1.3927391666666666,2012,3
53,2012-09-14,Stolen,35000000,289773,17967746,18257519,-16742481,-0.4783566,2012,9
53,2012-09-28,The Other Dream Team,500000,134109,314444,448553,-51447,-0.102894,2012,9
53,2012-11-09,Nothing But a Man,300000,17241,17241,34482,-265518,-0.88506,2012,11
53,2013-02-22,Inescapable,4000000,4327,4327,8654,-3991346,-0.9978365,2013,2
53,2013-03-01,The Sweeney,4500000,26345,8000366,8026711,3526711,0.7837135555555556,2013,3
53,2013-05-31,After Earth,130000000,60522097,251499665,312021762,182021762,1.4001674,2013,5
53,2013-06-21,Monsters University,200000000,268488329,743588329,1012076658,812076658,4.06038329,2013,6
53,2013-08-23,Yi dai zong shi,38600000,6594959,57987299,64582258,25982258,0.6731154922279793,2013,8
53,2013-09-13,Insidious Chapter 2,5000000,83586447,161921515,245507962,240507962,48.1015924,2013,9
53,2013-10-04,Runner Runner,30000000,19316646,60512680,79829326,49829326,1.6609775333333334,2013,10
53,2015-10-23,Jem and the Holograms,5000000,2184640,2368937,4553577,-446423,-0.0892846,2015,10
53,2017-03-24,CHiPS,25000000,18600152,23190292,41790444,16790444,0.67161776,2017,3
53,2017-11-03,Lady Bird,10000000,48958273,78610769,127569042,117569042,11.7569042,2017,11
54,1967-06-13,You Only Live Twice,9500000,43100000,111600000,154700000,145200000,15.284210526315789,1967,6
54,1978-10-24,The Wiz,24000000,22000000,22000000,44000000,20000000,0.8333333333333334,1978,10
54,1995-05-19,Die Hard: With a Vengeance,90000000,100012499,366101666,466114165,376114165,4.179046277777778,1995,5
54,1996-08-16,Kansas City,19000000,1353824,1353824,2707648,-16292352,-0.8574922105263157,1996,8
54,1996-11-15,The Mirror Has Two Faces,42000000,41267469,41267469,82534938,40534938,0.9651175714285715,1996,11
54,1997-09-26,Soul Food,7500000,43492389,43492389,86984778,79484778,10.5979704,1997,9
54,1998-02-06,The Replacement Killers,30000000,19035741,19035741,38071482,8071482,0.2690494,1998,2
54,1998-03-13,The Man in the Iron Mask,35000000,56968169,56968169,113936338,78936338,2.2553239428571428,1998,3
54,2000-03-03,Drowning Mona,16000000,15427192,15980376,31407568,15407568,0.962973,2000,3
54,2001-06-22,The Fast and the Furious,38000000,144512310,206512310,351024620,313024620,8.23749,2001,6
54,2002-05-31,The Sum of All Fears,68000000,118471320,193500000,311971320,243971320,3.587813529411765,2002,5
54,2002-07-19,Ayurveda: Art of Being,300000,16892,2066892,2083784,1783784,5.945946666666667,2002,7
54,2002-10-11,Punch-Drunk Love,25000000,17791031,24591031,42382062,17382062,0.69528248,2002,10
54,2003-05-30,The Italian Job,60000000,106126012,176262839,282388851,222388851,3.70648085,2003,5
54,2004-01-16,Teacher's Pet: The Movie,10000000,6491969,6491969,12983938,2983938,0.2983938,2004,1
54,2004-03-19,Eternal Sunshine of the Spotless Mind,20000000,34366518,72570762,106937280,86937280,4.346864,2004,3
54,2004-12-15,Million Dollar Baby,30000000,100492203,231928227,332420430,302420430,10.080681,2004,12
54,2005-04-15,It's All Gone Pete Tong,2000000,120620,2226603,2347223,347223,0.1736115,2005,4
54,2005-09-09,The Man,20000000,8330720,10393696,18724416,-1275584,-0.0637792,2005,9
54,2005-10-14,Elizabethtown,54000000,26850426,50719373,77569799,23569799,0.43647775925925925,2005,10
54,2006-08-11,Step Up,12000000,65328121,110989157,176317278,164317278,13.6931065,2006,8
54,2007-01-05,Thr3e,2400000,1008849,1420418,2429267,29267,0.012194583333333333,2007,1
54,2007-05-11,28 Weeks Later,15000000,28638916,64232714,92871630,77871630,5.191442,2007,5
54,2007-07-02,Transformers,151000000,319246193,708272592,1027518785,876518785,5.8047601655629135,2007,7
54,2007-07-27,MoliÃ¨re,21600000,635733,791154,1426887,-20173113,-0.9339404166666667,2007,7
54,2008-11-26,Four Christmases,80000000,120146040,168311558,288457598,208457598,2.605719975,2008,11
54,2008-11-26,Australia,130000000,49554002,215080810,264634812,134634812,1.0356524,2008,11
54,2009-09-11,The Horse Boy,160000,156612,156612,313224,153224,0.95765,2009,9
54,2009-11-06,Precious (Based on the Novel Push by Sapphire),10000000,47566524,68722848,116289372,106289372,10.6289372,2009,11
54,2009-11-25,Ninja Assassin,50000000,38122883,62209892,100332775,50332775,1.0066555,2009,11
54,2010-04-16,Kick-Ass,28000000,48071303,97531134,145602437,117602437,4.200087035714286,2010,4
54,2010-06-04,Killers,75000000,47059963,95572749,142632712,67632712,0.9017694933333333,2010,6
54,2010-10-15,N-Secure,1600000,2595644,2595644,5191288,3591288,2.244555,2010,10
54,2011-05-13,Hesher,7000000,382946,382946,765892,-6234108,-0.8905868571428571,2011,5
54,2011-07-29,The Guard,6000000,5359774,21197454,26557228,20557228,3.4262046666666666,2011,7
54,2011-09-09,Tanner Hall,3000000,5073,5073,10146,-2989854,-0.996618,2011,9
54,2011-10-14,Trespass,35000000,16816,786532,803348,-34196652,-0.9770472,2011,10
54,2012-08-03,Celeste and Jesse Forever,840000,3103407,3787689,6891096,6051096,7.203685714285714,2012,8
54,2012-10-05,Taken 2,45000000,139854287,377807404,517661691,472661691,10.503593133333334,2012,10
54,2013-03-08,Oz the Great and Powerful,200000000,234770996,490359051,725130047,525130047,2.625650235,2013,3
54,2013-05-31,Yeh Jawaani Hai Deewani,8300000,3827466,50827466,54654932,46354932,5.58493156626506,2013,5
54,2014-07-18,Sex Tape,40000000,38543473,126069509,164612982,124612982,3.11532455,2014,7
54,2014-09-04,Falcon Rising,4500000,11774,11774,23548,-4476452,-0.9947671111111112,2014,9
54,2015-12-11,O Menino e o Mundo,500000,129479,280967,410446,-89554,-0.179108,2015,12
54,2016-03-11,10 Cloverfield Lane,5000000,72082999,108286422,180369421,175369421,35.0738842,2016,3
54,2016-06-24,The Shallows,13000000,55121623,118763442,173885065,160885065,12.375774230769231,2016,6
54,2016-12-28,Paterson,5000000,2141423,10727536,12868959,7868959,1.5737918,2016,12
54,2017-09-22,Kingsman: The Golden Circle,104000000,100234838,408803696,509038534,405038534,3.8946012884615384,2017,9
54,2017-10-06,Visages villages,1000000,952432,4015686,4968118,3968118,3.968118,2017,10
54,2018-03-23,Sherlock Gnomes,59000000,43242871,87527651,130770522,71770522,1.2164495254237289,2018,3
54,2018-07-06,Sorry to Bother You,3200000,17493096,18285560,35778656,32578656,10.18083,2018,7
55,1962-04-22,The Man Who Shot Liberty Valance,3200000,8000000,8000000,16000000,12800000,4.0,1962,4
55,1985-06-28,Red Sonja,17900000,6905861,6908640,13814501,-4085499,-0.22824016759776536,1985,6
55,1987-01-30,Radio Days,16000000,14792779,14792779,29585558,13585558,0.849097375,1987,1
55,1987-07-17,RoboCop,13000000,53424681,53424681,106849362,93849362,7.219181692307692,1987,7
55,1988-06-10,Poltergeist III,9500000,14114000,14114000,28228000,18728000,1.9713684210526317,1988,6
55,1994-05-27,The Flintstones,45000000,130531208,358500000,489031208,444031208,9.867360177777778,1994,5
55,1995-09-22,Se7en,30000000,100125643,328125643,428251286,398251286,13.275042866666666,1995,9
55,1997-04-11,Grosse Pointe Blank,15000000,28084357,31070412,59154769,44154769,2.9436512666666665,1997,4
55,1997-06-27,Face/Off,80000000,112276146,241200000,353476146,273476146,3.418451825,1997,6
55,1998-01-30,Zero Effect,5000000,2080693,2080693,4161386,-838614,-0.1677228,1998,1
55,1998-03-13,Chairman of the Board,7000000,306715,306715,613430,-6386570,-0.9123671428571428,1998,3
55,1998-08-07,"First Love, Last Rites",300000,10876,10876,21752,-278248,-0.9274933333333333,1998,8
55,1999-06-04,Limbo,8300000,2160710,2598224,4758934,-3541066,-0.4266344578313253,1999,6
55,1999-10-15,The Straight Story,10000000,6197866,6197866,12395732,2395732,0.2395732,1999,10
55,2000-04-21,The Virgin Suicides,6000000,4859475,10619770,15479245,9479245,1.5798741666666667,2000,4
55,2000-06-09,Gone in 60 Seconds,103300000,101643008,232643008,334286016,230986016,2.2360698547918685,2000,6
55,2001-04-06,Brigham City,1000000,852206,852206,1704412,704412,0.704412,2001,4
55,2001-09-28,Zoolander,28000000,45172250,60780981,105953231,77953231,2.7840439642857144,2001,9
55,2002-03-01,The Calling,160000,32092,32092,64184,-95816,-0.59885,2002,3
55,2002-09-27,Sweet Home Alabama,38000000,127214072,182365114,309579186,271579186,7.146820684210526,2002,9
55,2002-10-25,Time Changer,825000,1500711,1500711,3001422,2176422,2.638087272727273,2002,10
55,2003-05-09,Daddy Day Care,60000000,104148781,164285587,268434368,208434368,3.473906133333333,2003,5
55,2003-08-01,Gigli,54000000,6087542,7126002,13213544,-40786456,-0.7553047407407407,2003,8
55,2004-01-23,Win a Date with Tad Hamilton!,24000000,16980098,16980098,33960196,9960196,0.4150081666666667,2004,1
55,2004-02-20,Eurotrip,25000000,17718223,20718223,38436446,13436446,0.53745784,2004,2
55,2004-05-28,Raising Helen,50000000,37485528,49928680,87414208,37414208,0.74828416,2004,5
55,2005-09-30,My Big Fat Independent Movie,3000000,4655,4655,9310,-2990690,-0.9968966666666667,2005,9
55,2006-09-01,Idiocracy,2400000,444093,500296,944389,-1455611,-0.6065045833333333,2006,9
55,2007-01-05,Code Name: The Cleaner,20000000,8135024,8135024,16270048,-3729952,-0.1864976,2007,1
55,2007-10-05,Michael Clayton,21500000,49033882,92987651,142021533,120521533,5.605652697674419,2007,10
55,2008-02-01,Sukkar banat,1600000,1060591,14253760,15314351,13714351,8.571469375,2008,2
55,2009-07-17,(500) Days of Summer,7500000,32425665,34439060,66864725,59364725,7.915296666666666,2009,7
55,2010-01-29,Saint John of Las Vegas,2000000,102645,102645,205290,-1794710,-0.897355,2010,1
55,2011-03-11,Red Riding Hood,42000000,37662162,91678442,129340604,87340604,2.0795381904761903,2011,3
55,2011-04-01,Rubber,500000,100370,680914,781284,281284,0.562568,2011,4
55,2011-04-15,Scream 4,40000000,38180928,95989590,134170518,94170518,2.35426295,2011,4
55,2011-07-22,Friends with Benefits,35000000,55802754,146595891,202398645,167398645,4.782818428571429,2011,7
55,2012-02-03,Chronicle,12000000,64575175,123681790,188256965,176256965,14.688080416666667,2012,2
55,2012-05-04,The Best Exotic Marigold Hotel,10000000,46383639,134639780,181023419,171023419,17.1023419,2012,5
55,2013-01-04,Texas Chainsaw 3D,20000000,34341945,47666013,82007958,62007958,3.1003979,2013,1
55,2013-07-19,R.I.P.D.,130000000,33618855,79076678,112695533,-17304467,-0.13311128461538463,2013,7
55,2014-05-23,X-Men: Days of Future Past,200000000,233921534,747862775,981784309,781784309,3.908921545,2014,5
55,2015-06-26,Ted 2,68000000,81476385,217214143,298690528,230690528,3.3925077647058823,2015,6
55,2015-08-14,The Man From U.N.C.L.E.,75000000,45445109,104949584,150394693,75394693,1.0052625733333334,2015,8
55,2016-07-22,Lights Out,5000000,67268835,148806510,216075345,211075345,42.215069,2016,7
55,2016-09-23,The Magnificent Seven,90000000,93432655,162525156,255957811,165957811,1.8439756777777778,2016,9
55,2017-04-28,Baahubali 2: The Conclusion,30000000,18985794,263502914,282488708,252488708,8.416290266666667,2017,4
55,2017-06-02,Wonder Woman,150000000,412563408,821133378,1233696786,1083696786,7.22464524,2017,6
55,2019-01-25,The Kid Who Would Be King,59000000,16790790,28348446,45139236,-13860764,-0.2349282033898305,2019,1
56,1971-01-01,Sweet Sweetback's Baad Asssss Song,150000,15200000,15200000,30400000,30250000,201.66666666666666,1971,1
56,1988-08-19,A Nightmare on Elm Street 4: The Dream Master,13000000,49369899,49369899,98739798,85739798,6.595369076923077,1988,8
56,1989-12-31,Out of the Dark,1600000,419428,419428,838856,-761144,-0.475715,1989,12
56,1991-01-01,Johnny Suede,500000,55000,55000,110000,-390000,-0.78,1991,1
56,1992-04-24,A Midnight Clear,5000000,1526697,1526697,3053394,-1946606,-0.3893212,1992,4
56,1994-09-16,Timecop,28000000,44853581,102053581,146907162,118907162,4.246684357142857,1994,9
56,1994-12-21,Ri¢hie Ri¢h,40000000,38087756,38087756,76175512,36175512,0.9043878,1994,12
56,1996-02-23,Rumble in the Bronx,7500000,32281907,36238752,68520659,61020659,8.136087866666667,1996,2
56,1996-12-20,Beavis and Butt-Head Do America,12000000,63118386,63118386,126236772,114236772,9.519731,1996,12
56,1998-04-15,24 7: Twenty Four Seven,2000000,72544,72544,145088,-1854912,-0.927456,1998,4
56,1999-06-18,The General's Daughter,60000000,102705852,149705852,252411704,192411704,3.206861733333333,1999,6
56,1999-07-09,Arlington Road,21500000,24419219,24419219,48838438,27338438,1.2715552558139536,1999,7
56,1999-07-14,Muppets From Space,24000000,16304786,16304786,32609572,8609572,0.3587321666666667,1999,7
56,2000-04-21,Love and Basketball,15000000,27441122,27709625,55150747,40150747,2.6767164666666665,2000,4
56,2000-05-05,Gladiator,103000000,187683805,457683805,645367610,542367610,5.265704951456311,2000,5
56,2000-06-16,Shaft,53012938,70327868,107190108,177517976,124505038,2.348578341385267,2000,6
56,2001-07-13,The Score,68000000,71069884,113542091,184611975,116611975,1.7148819852941177,2001,7
56,2002-01-25,The Mothman Prophecies,42000000,35228696,56438555,91667251,49667251,1.1825535952380952,2002,1
56,2002-05-03,Deuces Wild,10000000,6044618,6244618,12289236,2289236,0.2289236,2002,5
56,2003-02-14,Gerry,7000000,254683,719699,974382,-6025618,-0.8608025714285714,2003,2
56,2003-03-07,Tears of the Sun,75000000,43632458,85632458,129264916,54264916,0.7235322133333333,2003,3
56,2003-07-18,How to Deal,16000000,14108518,14108518,28217036,12217036,0.76356475,2003,7
56,2003-10-08,Mystic River,30000000,90135191,156822020,246957211,216957211,7.231907033333333,2003,10
56,2003-10-24,Scary Movie 3,45000000,110000082,155200000,265200082,220200082,4.8933351555555555,2003,10
56,2004-07-16,Maria Full of Grace,3200000,6529624,14441158,20970782,17770782,5.553369375,2004,7
56,2005-05-06,Fighting Tommy Riley,300000,10514,10514,21028,-278972,-0.9299066666666667,2005,5
56,2005-06-24,George A. Romero's Land of the Dead,18975000,20700082,47751015,68451097,49476097,2.6074359420289857,2005,6
56,2006-03-03,Ultraviolet,30000000,18522064,30962112,49484176,19484176,0.6494725333333333,2006,3
56,2006-10-27,Babel,20000000,34302837,132121212,166424049,146424049,7.32120245,2006,10
56,2007-03-16,The Wind That Shakes the Barley,8300000,1829142,25670174,27499316,19199316,2.3131706024096386,2007,3
56,2008-08-29,College,6000000,4694491,6176114,10870605,4870605,0.8117675,2008,8
56,2008-12-25,Bedtime Stories,80000000,110101975,221468935,331570910,251570910,3.144636375,2008,12
56,2009-07-24,The Ugly Truth,38000000,88915214,205298907,294214121,256214121,6.742476868421052,2009,7
56,2012-07-13,Red Lights,17700000,49521,14518884,14568405,-3131595,-0.17692627118644066,2012,7
56,2013-11-22,Frozen,150000000,400738009,1272469910,1673207919,1523207919,10.15471946,2013,11
56,2014-05-02,The Amazing Spider-Man 2,200000000,202853933,708996336,911850269,711850269,3.559251345,2014,5
56,2014-12-12,Inherent Vice,20000000,8110975,14772346,22883321,2883321,0.14416605,2014,12
56,2015-09-11,The Visit,5000000,65206105,98677816,163883921,158883921,31.7767842,2015,9
56,2015-12-18,Alvin and the Chipmunks: The Road Chip,90000000,85886987,249517956,335404943,245404943,2.7267215888888887,2015,12
56,2016-02-12,Deadpool,58000000,363070709,801025593,1164096302,1106096302,19.070625896551725,2016,2
56,2016-05-20,Neighbors 2: Sorority Rising,35000000,55340730,108757621,164098351,129098351,3.6885243142857145,2016,5
56,2016-05-20,The Nice Guys,50000000,36261763,59596747,95858510,45858510,0.9171702,2016,5
56,2016-12-21,Dangal,9500000,12391761,294654618,307046379,297546379,31.32067147368421,2016,12
56,2017-08-18,Patti Cake$,1000000,800148,1471090,2271238,1271238,1.271238,2017,8
56,2017-12-22,Father Figures,25000000,17501244,21038441,38539685,13539685,0.5415874,2017,12
56,2018-06-08,Hereditary,10000000,44069456,70133905,114203361,104203361,10.4203361,2018,6
56,2019-02-22,How to Train Your Dragon: The Hidden World,129000000,160791800,519258283,680050083,551050083,4.271706069767442,2019,2
57,1970-01-01,Patton,12000000,62500000,62500000,125000000,113000000,9.416666666666666,1970,1
57,1989-07-14,Licence to Kill,42000000,34667015,156167015,190834030,148834030,3.543667380952381,1989,7
57,1996-05-17,Flipper,25530000,20080020,30593313,50673333,25143333,0.9848544065804935,1996,5
57,1996-12-20,My Fellow Americans,21500000,22331846,22331846,44663692,23163692,1.0773810232558139,1996,12
57,1998-12-18,The Prince of Egypt,60000000,101413188,218613188,320026376,260026376,4.333772933333333,1998,12
57,1999-09-17,For Love of the Game,50000000,35188640,46112640,81301280,31301280,0.6260256,1999,9
57,2000-04-07,Ready to Rumble,24000000,12372410,12372410,24744820,744820,0.031034166666666668,2000,4
57,2000-08-11,Autumn in New York,40000000,37752931,90717684,128470615,88470615,2.211765375,2000,8
57,2000-12-01,Panic,1000000,779137,1425707,2204844,1204844,1.204844,2000,12
57,2000-12-22,Miss Congeniality,45000000,106807667,213420951,320228618,275228618,6.116191511111111,2000,12
57,2001-06-08,Atlantis: The Lost Empire,90000000,84052762,186049020,270101782,180101782,2.0011309111111113,2001,6
57,2002-07-12,Road to Perdition,80000000,104054514,183354514,287409028,207409028,2.59261285,2002,7
57,2002-08-07,Spy Kids 2: The Island of Lost Dreams,38000000,85846296,119721296,205567592,167567592,4.409673473684211,2002,8
57,2002-10-25,Jackass: The Movie,5000000,64282312,79282312,143564624,138564624,27.7129248,2002,10
57,2004-04-16,Connie & Carla,20000000,8047525,8047525,16095050,-3904950,-0.1952475,2004,4
57,2004-10-22,The Machinist,5000000,1082044,8655397,9737441,4737441,0.9474882,2004,10
57,2004-10-29,Saw,1200000,55968727,103880027,159848754,158648754,132.207295,2004,10
57,2005-08-05,The Dukes of Hazzard,53000000,80270227,109848461,190118688,137118688,2.5871450566037737,2005,8
57,2005-10-21,North Country,30000000,18324242,23676771,42001013,12001013,0.4000337666666667,2005,10
57,2006-01-27,Bubble,1600000,145382,145382,290764,-1309236,-0.8182725,2006,1
57,2006-03-17,Thank You For Smoking,7500000,24793509,40016662,64810171,57310171,7.641356133333334,2006,3
57,2006-05-12,Wah-Wah,7000000,234750,463039,697789,-6302211,-0.9003158571428571,2006,5
57,2006-07-21,Lady in the Water,75000000,42285169,72785169,115070338,40070338,0.5342711733333333,2006,7
57,2006-09-22,La science des rÃªves,6000000,4670644,15137932,19808576,13808576,2.3014293333333335,2006,9
57,2006-12-15,IndigÃ¨nes,18900000,320700,26063572,26384272,7484272,0.3959932275132275,2006,12
57,2007-03-23,TMNT,35000000,54149098,96096018,150245116,115245116,3.2927176,2007,3
57,2007-05-16,Once,150000,9445857,23323631,32769488,32619488,217.46325333333334,2007,5
57,2007-07-27,No Reservations,28000000,43107979,91943956,135051935,107051935,3.823283392857143,2007,7
57,2007-08-17,Superbad,17500000,121463226,169955142,291418368,273918368,15.652478171428571,2007,8
57,2007-10-05,Finishing the Game,500000,52850,53201,106051,-393949,-0.787898,2007,10
57,2007-11-21,This Christmas,13000000,49121934,49733545,98855479,85855479,6.604267615384615,2007,11
57,2008-03-28,"Run, Fatboy, Run",10000000,6003262,33512260,39515522,29515522,2.9515522,2008,3
57,2008-04-04,The Ruins,25000000,17432844,22910563,40343407,15343407,0.61373628,2008,4
57,2010-03-19,The Runaways,9500000,3573673,5278632,8852305,-647695,-0.06817842105263158,2010,3
57,2010-04-16,The City of Your Final Destination,8300000,493296,1353296,1846592,-6453408,-0.7775190361445783,2010,4
57,2011-02-25,Hall Pass,68000000,45060734,87173475,132234209,64234209,0.9446207205882353,2011,2
57,2011-06-03,Beginners,3200000,5790894,14314407,20105301,16905301,5.2829065625,2011,6
57,2011-06-24,Cars 2,200000000,191450875,560155383,751606258,551606258,2.75803129,2011,6
57,2011-11-18,"The Twilight Saga: Breaking Dawn, Part 1",127500000,281287133,689420051,970707184,843207184,6.613389678431372,2011,11
57,2013-05-23,The Hangover 3,103000000,112200072,362000072,474200144,371200144,3.6038848932038836,2013,5
57,2014-03-28,Locker 13,300000,3496,3496,6992,-293008,-0.9766933333333333,2014,3
57,2014-09-19,Pump,2000000,72277,72277,144554,-1855446,-0.927723,2014,9
57,2014-09-19,This is Where I Leave You,20000000,34296320,41296320,75592640,55592640,2.779632,2014,9
57,2014-10-03,Left Behind,16000000,14019924,20769209,34789133,18789133,1.1743208125,2014,10
57,2014-12-25,American Sniper,58000000,350126372,547326372,897452744,839452744,14.473323172413792,2014,12
57,2015-12-18,Sisters,30000000,87044645,106030660,193075305,163075305,5.4358435,2015,12
57,2016-03-04,Zootopia,150000000,341268248,1019429616,1360697864,1210697864,8.071319093333333,2016,3
57,2016-09-23,The Dressmaker,11900000,2022115,24041617,26063732,14163732,1.1902295798319327,2016,9
57,2017-09-08,Home Again,15000000,27020284,37336874,64357158,49357158,3.2904772,2017,9
57,2018-03-16,"Love, Simon",10000000,40826341,65520633,106346974,96346974,9.6346974,2018,3
58,1971-01-01,Billy Jack,800000,98000000,98000000,196000000,195200000,244.0,1971,1
58,1981-12-18,Heartbeeps,10000000,6000000,6000000,12000000,2000000,0.2,1981,12
58,1989-02-17,Bill & Ted's Excellent Adventure,10000000,40485039,40485039,80970078,70970078,7.0970078,1989,2
58,1989-08-04,"Sex, Lies, and Videotape",1200000,24741667,36741667,61483334,60283334,50.236111666666666,1989,8
58,1992-09-21,Light Sleeper,5000000,1050861,1050861,2101722,-2898278,-0.5796556,1992,9
58,1993-07-16,Hocus Pocus,28000000,39360491,39360491,78720982,50720982,1.811463642857143,1993,7
58,1994-11-18,Star Trek: Generations,38000000,75671262,120000000,195671262,157671262,4.149243736842105,1994,11
58,1995-11-22,Money Train,68000000,35324232,77224232,112548464,44548464,0.6551244705882353,1995,11
58,1998-12-04,Little Voice,6000000,4595000,21787233,26382233,20382233,3.3970388333333332,1998,12
58,1998-12-11,Jack Frost,50000000,34645374,34645374,69290748,19290748,0.38581496,1998,12
58,1999-11-10,Pokemon: The First Movie,30000000,85744662,163644662,249389324,219389324,7.312977466666666,1999,11
58,1999-12-10,Diamonds,11900000,81897,81897,163794,-11736206,-0.9862357983193277,1999,12
58,2000-05-19,Dinosaur,127500000,137748063,356148063,493896126,366396126,2.8736951058823528,2000,5
58,2000-10-27,Book of Shadows: Blair Witch 2,15000000,26421314,47721314,74142628,59142628,3.9428418666666665,2000,10
58,2002-07-19,Tadpole,150000,2891288,3270128,6161416,6011416,40.07610666666667,2002,7
58,2003-06-13,The Heart of Me,7000000,196067,196067,392134,-6607866,-0.9439808571428572,2003,6
58,2003-10-24,Radio,35000000,52333738,53293628,105627366,70627366,2.0179247428571427,2003,10
58,2004-05-28,Soul Plane,16000000,13922211,14553807,28476018,12476018,0.779751125,2004,5
58,2004-08-06,Collateral,60000000,100170152,217670152,317840304,257840304,4.2973384,2004,8
58,2004-12-17,Spanglish,75000000,42044321,54344321,96388642,21388642,0.2851818933333333,2004,12
58,2005-04-15,The Amityville Horror,18500000,65233369,109175673,174409042,155909042,8.427515783783784,2005,4
58,2005-08-31,The Constant Gardener,25500000,33579798,86301599,119881397,94381397,3.701231254901961,2005,8
58,2005-09-23,Dil Jo Bhi Kahey...,1600000,129319,129319,258638,-1341362,-0.83835125,2005,9
58,2007-06-08,Hostel: Part II,7500000,17544812,33606409,51151221,43651221,5.8201628,2007,6
58,2007-07-11,Harry Potter and the Order of the Phoenix,150000000,292137260,943076457,1235213717,1085213717,7.234758113333333,2007,7
58,2007-07-25,This is England,2380000,327919,8739576,9067495,6687495,2.809871848739496,2007,7
58,2008-04-18,Kiss the Bride,500000,32033,32033,64066,-435934,-0.871868,2008,4
58,2008-10-24,Roadside Romeo,2000000,55202,2046090,2101292,101292,0.050646,2008,10
58,2008-12-12,Doubt,20000000,33446470,53191101,86637571,66637571,3.33187855,2008,12
58,2008-12-25,Valkyrie,90000000,83107829,203932174,287040003,197040003,2.189333366666667,2008,12
58,2009-02-20,Madea Goes To Jail,17500000,90508336,90508336,181016672,163516672,9.343809828571429,2009,2
58,2009-10-16,Law Abiding Citizen,53000000,73357727,131159781,204517508,151517508,2.8588209056603775,2009,10
58,2009-10-30,Gentlemen Broncos,9500000,115155,119955,235110,-9264890,-0.9752515789473685,2009,10
58,2010-12-17,Tron: Legacy,200000000,172062763,400062763,572125526,372125526,1.86062763,2010,12
58,2011-02-11,Just Go With It,80000000,103028109,214974953,318003062,238003062,2.975038275,2011,2
58,2011-03-18,Paul,40000000,37412945,101162106,138575051,98575051,2.464376275,2011,3
58,2011-08-19,Fright Night,30000000,18298649,40520649,58819298,28819298,0.9606432666666667,2011,8
58,2011-09-16,I Don't Know How She Does It,24000000,9659074,24474463,34133537,10133537,0.4222307083333333,2011,9
58,2011-12-25,The Darkest Hour,34800000,21443494,62831715,84275209,49475209,1.421701408045977,2011,12
58,2012-03-02,Project X,12000000,54731865,103028188,157760053,145760053,12.146671083333333,2012,3
58,2012-06-22,To Rome with Love,21500000,16684352,74326015,91010367,69510367,3.2330403255813955,2012,6
58,2013-10-11,Machete Kills,20000000,8008161,18273009,26281170,6281170,0.3140585,2013,10
58,2013-10-25,The Counselor,25000000,16973715,71009334,87983049,62983049,2.51932196,2013,10
58,2014-02-14,About Last Night,13000000,48637684,50445860,99083544,86083544,6.621811076923077,2014,2
58,2014-05-09,Palo Alto,1000000,767732,1156309,1924041,924041,0.924041,2014,5
58,2015-10-16,Goosebumps,58000000,80069458,158905324,238974782,180974782,3.1202548620689656,2015,10
58,2015-10-23,The Looking Glass,300000,1711,1711,3422,-296578,-0.9885933333333333,2015,10
58,2016-04-22,The Meddler,3200000,4267219,5526942,9794161,6594161,2.0606753125,2016,4
58,2017-10-13,Happy Death Day,5000000,55683845,125010260,180694105,175694105,35.138821,2017,10
58,2017-12-22,Pitch Perfect 3,45000000,104897530,185736412,290633942,245633942,5.4585320444444445,2017,12
58,2018-03-09,A Wrinkle in Time,103000000,100478608,133401882,233880490,130880490,1.2706843689320388,2018,3
58,2018-12-25,Holmes & Watson,42000000,30568743,41926605,72495348,30495348,0.7260797142857143,2018,12
59,1944-06-27,Bathing Beauty,2361000,3500000,3500000,7000000,4639000,1.964845404489623,1944,6
59,1951-02-23,Quo Vadis?,8250000,30000000,30028513,60028513,51778513,6.276183393939394,1951,2
59,1962-10-04,The Longest Day,10000000,39100000,50100000,89200000,79200000,7.92,1962,10
59,1969-01-01,Sweet Charity,20000000,8000000,8000000,16000000,-4000000,-0.2,1969,1
59,1988-05-25,Rambo III,58000000,53715611,188715611,242431222,184431222,3.179848655172414,1988,5
59,1988-12-09,My Stepmother Is an Alien,16000000,13854000,13854000,27708000,11708000,0.73175,1988,12
59,1997-10-10,Boogie Nights,15000000,26410771,43111725,69522496,54522496,3.634833066666667,1997,10
59,1998-03-20,Madadayo,11900000,48856,48856,97712,-11802288,-0.9917889075630252,1998,3
59,1999-01-15,Mississippi Mermaid,1600000,27795,2627795,2655590,1055590,0.65974375,1999,1
59,1999-12-24,Play it to the Bone,24000000,8427204,8427204,16854408,-7145592,-0.297733,1999,12
59,2000-06-23,The Woman Chaser,150000,110719,110719,221438,71438,0.4762533333333333,2000,6
59,2000-09-08,Fiza,1000000,623791,1179462,1803253,803253,0.803253,2000,9
59,2000-12-15,"Dude, Where's My Car?",13000000,46729374,73180297,119909671,106909671,8.223820846153846,2000,12
59,2001-05-04,Eureka,2000000,49388,76654,126042,-1873958,-0.936979,2001,5
59,2001-07-04,Cats & Dogs,60000000,93375151,200700000,294075151,234075151,3.9012525166666667,2001,7
59,2001-10-12,Bandits,75000000,41523271,71523271,113046542,38046542,0.5072872266666667,2001,10
59,2002-02-15,Super Troopers,1200000,18492362,23046142,41538504,40338504,33.61542,2002,2
59,2002-12-06,Adaptation,18500000,22498520,32531759,55030279,36530279,1.9746096756756757,2002,12
59,2003-02-14,Daredevil,80000000,102543518,182782518,285326036,205326036,2.56657545,2003,2
59,2003-03-21,Dreamcatcher,68000000,33685268,75685268,109370536,41370536,0.6083902352941176,2003,3
59,2003-07-11,The Journey,500000,19800,19800,39600,-460400,-0.9208,2003,7
59,2004-10-15,Team America: World Police,20000000,32774834,50948811,83723645,63723645,3.18618225,2004,10
59,2004-11-19,SpongeBob SquarePants: The Movie,30000000,85416609,142051255,227467864,197467864,6.582262133333334,2004,11
59,2005-11-11,Pride & Prejudice,28000000,38372662,126549607,164922269,136922269,4.890081035714286,2005,11
59,2005-11-18,Harry Potter and the Goblet of Fire,150000000,290201752,897099794,1187301546,1037301546,6.91534364,2005,11
59,2006-12-08,Unaccompanied Minors,25000000,16655224,21970831,38626055,13626055,0.5450422,2006,12
59,2008-02-14,Step Up 2 the Streets,17500000,58017783,148586910,206604693,189104693,10.805982457142857,2008,2
59,2008-07-11,Journey to the Center of the Earth,45000000,101704370,243180937,344885307,299885307,6.664117933333333,2008,7
59,2008-07-25,American Teen,5000000,942441,989319,1931760,-3068240,-0.613648,2008,7
59,2008-10-17,W.,25100000,25534493,28575778,54110271,29010271,1.1557876892430279,2008,10
59,2009-03-13,Miss March,6000000,4543320,4713059,9256379,3256379,0.5427298333333334,2009,3
59,2009-07-01,Public Enemies,102500000,97104620,212282709,309387329,206887329,2.0184129658536585,2009,7
59,2009-07-29,Adam,3200000,2283291,2834485,5117776,1917776,0.599305,2009,7
59,2009-10-09,An Education,7500000,12574914,29652736,42227650,34727650,4.630353333333334,2009,10
59,2009-11-13,2012,200000000,166112167,757677748,923789915,723789915,3.618949575,2009,11
59,2010-03-26,Ca$h,7000000,46488,46488,92976,-6907024,-0.9867177142857143,2010,3
59,2010-06-04,Marmaduke,50000000,33644788,89895930,123540718,73540718,1.47081436,2010,6
59,2011-12-30,Jodaeiye Nader az Simin,800000,7098492,24426169,31524661,30724661,38.40582625,2011,12
59,2012-01-27,One for the Money,42000000,26414527,36197221,62611748,20611748,0.4907559047619048,2012,1
59,2012-10-19,Paranormal Activity 4,5000000,53900335,142817992,196718327,191718327,38.3436654,2012,10
59,2012-11-16,Silver Linings Playbook,21000000,132092958,236412453,368505411,347505411,16.547876714285714,2012,11
59,2012-12-19,The Guilt Trip,40000000,37134215,41294674,78428889,38428889,0.960722225,2012,12
59,2015-03-20,Danny Collins,10000000,5637066,8465845,14102911,4102911,0.4102911,2015,3
59,2015-07-24,Pixels,90000000,78765986,244041804,322807790,232807790,2.5867532222222223,2015,7
59,2015-09-18,Black Mass,53000000,62575678,98837872,161413550,108413550,2.045538679245283,2015,9
59,2017-03-03,Logan,127000000,226277068,615461394,841738462,714738462,5.627861905511811,2017,3
59,2017-06-02,Captain Underpants: The First Epic Movie,38000000,73921000,126577874,200498874,162498874,4.276286157894737,2017,6
59,2017-06-28,Baby Driver,34000000,107825862,228104185,335930047,301930047,8.8802955,2017,6
59,2017-09-15,mother!,30000000,17800004,42531076,60331080,30331080,1.011036,2017,9
59,2017-11-10,"Three Billboards Outside Ebbing, Missouri",12000000,54513740,160191915,214705655,202705655,16.892137916666666,2017,11
59,2018-06-29,Sicario: Day of the Soldado,35000000,50065850,75885196,125951046,90951046,2.5986013142857143,2018,6
60,1963-11-07,It's a Mad Mad Mad Mad World,9400000,46300000,60000000,106300000,96900000,10.308510638297872,1963,11
60,1965-03-02,The Sound of Music,8200000,163214286,286214286,449428572,441228572,53.80836243902439,1965,3
60,1975-11-19,One Flew Over the Cuckoo's Nest,4400000,108981275,108997629,217978904,213578904,48.54066,1975,11
60,1988-08-12,Young Guns,13000000,44726644,44726644,89453288,76453288,5.881022153846154,1988,8
60,1993-12-17,The Pelican Brief,45000000,100768056,187995859,288763915,243763915,5.416975888888889,1993,12
60,1995-10-27,Copycat,20000000,32051917,32051917,64103834,44103834,2.2051917,1995,10
60,1995-12-15,Sabrina,58000000,53458319,87100000,140558319,82558319,1.4234192931034482,1995,12
60,1996-02-16,Happy Gilmore,10000000,38623460,41004412,79627872,69627872,6.9627872,1996,2
60,1996-05-10,Welcome to the Dollhouse,800000,4198137,5034794,9232931,8432931,10.54116375,1996,5
60,1996-06-28,Striptease,50000000,33109743,113309743,146419486,96419486,1.92838972,1996,6
60,1997-11-14,Anastasia,53000000,58403409,139801096,198204505,145204505,2.739707641509434,1997,11
60,1999-02-05,Simply Irresistible,6000000,4398989,4398989,8797978,2797978,0.46632966666666664,1999,2
60,1999-08-06,Mystery Men,68000000,29762011,33462011,63224022,-4775978,-0.07023497058823529,1999,8
60,1999-12-17,Anna and the King,75000000,39251128,39251128,78502256,3502256,0.046696746666666664,1999,12
60,2001-03-09,15 Minutes,42000000,24375436,56331864,80707300,38707300,0.921602380952381,2001,3
60,2001-06-29,Artificial Intelligence: AI,90000000,78616689,235900000,314516689,224516689,2.494629877777778,2001,6
60,2002-02-22,Monsoon Wedding,1200000,13876974,27025600,40902574,39702574,33.085478333333334,2002,2
60,2002-12-20,Two Weeks Notice,60000000,93354918,199043309,292398227,232398227,3.8733037833333333,2002,12
60,2003-05-15,The Matrix Reloaded,150000000,281553689,738576929,1020130618,870130618,5.800870786666667,2003,5
60,2004-02-25,The Passion of the Christ,25000000,370782930,622341924,993124854,968124854,38.72499416,2004,2
60,2006-01-13,Hoodwinked,17500000,51386611,109843390,161230001,143730001,8.213142914285715,2006,1
60,2006-02-24,Doogal,20000000,7578946,28058652,35637598,15637598,0.7818799,2006,2
60,2006-06-02,The Puffy Chair,15000,194523,195254,389777,374777,24.985133333333334,2006,6
60,2006-09-22,Feast,3200000,56131,690872,747003,-2452997,-0.7665615625,2006,9
60,2006-11-17,Casino Royale,102000000,167365000,594420283,761785283,659785283,6.468483166666666,2006,11
60,2007-07-04,Rescue Dawn,10000000,5490423,7037886,12528309,2528309,0.2528309,2007,7
60,2008-09-26,Eagle Eye,80000000,101440743,180585259,282026002,202026002,2.525325025,2008,9
60,2009-04-23,Home,500000,15433,44793168,44808601,44308601,88.617202,2009,4
60,2009-09-04,Extract,7500000,10823158,10849158,21672316,14172316,1.8896421333333333,2009,9
60,2009-10-02,The Invention of Lying,18500000,18451251,32679264,51130515,32630515,1.7638116216216215,2009,10
60,2009-11-25,Old Dogs,35000000,49492060,95104304,144596364,109596364,3.1313246857142856,2009,11
60,2009-12-04,Up in the Air,30000000,83823381,166842739,250666120,220666120,7.355537333333333,2009,12
60,2010-02-03,Ajami,1000000,621859,2721096,3342955,2342955,2.342955,2010,2
60,2010-07-23,Ramona and Beezus,15000000,26167002,27469621,53636623,38636623,2.575774866666667,2010,7
60,2011-08-12,30 Minutes or Less,28000000,37053924,40966716,78020640,50020640,1.7864514285714286,2011,8
60,2011-08-26,Colombiana,40000000,36665854,72295262,108961116,68961116,1.7240279,2011,8
60,2012-06-29,People Like Us,16000000,12431792,12617472,25049264,9049264,0.565579,2012,6
60,2013-12-20,Dhoom 3,24000000,8031955,11723620,19755575,-4244425,-0.17685104166666665,2013,12
60,2014-09-12,Atlas Shrugged: Who Is John Galt?,5000000,851690,851690,1703380,-3296620,-0.659324,2014,9
60,2014-09-19,The Maze Runner,34000000,102427862,348319861,450747723,416747723,12.257285970588235,2014,9
60,2014-09-26,Two Night Stand,1600000,15600,868081,883681,-716319,-0.447699375,2014,9
60,2014-10-24,Ouija,5000000,50856010,103300632,154156642,149156642,29.8313284,2014,10
60,2014-12-19,Night at the Museum: Secret of the Tomb,127000000,113746621,353756621,467503242,340503242,2.6811278897637796,2014,12
60,2015-01-30,Trudno byt bogom,7000000,31443,41038,72481,-6927519,-0.9896455714285715,2015,1
60,2015-03-20,Do You Believe?,2300000,12985600,14304931,27290531,24990531,10.865448260869565,2015,3
60,2015-04-07,Lost River,2000000,45431,2009644,2055075,55075,0.0275375,2015,4
60,2015-04-17,Antarctic Edge: 70Âº South,150000,7193,7193,14386,-135614,-0.9040933333333333,2015,4
60,2015-04-17,Paul Blart: Mall Cop 2,38000000,71091594,107650646,178742240,140742240,3.7037431578947366,2015,4
60,2015-10-09,Steve Jobs,30000000,17766658,35579007,53345665,23345665,0.7781888333333333,2015,10
60,2015-11-20,Carol,11800000,12711491,42843521,55555012,43755012,3.7080518644067797,2015,11
60,2016-11-25,Lion,12000000,51739495,149570720,201310215,189310215,15.77585125,2016,11
60,2018-04-06,Blockers,21000000,60311495,94045328,154356823,133356823,6.350324904761905,2018,4
60,2018-11-16,Fantastic Beasts: The Crimes of Grindelwald,200000000,159555901,652220086,811775987,611775987,3.058879935,2018,11
60,2018-12-07,Mary Queen of Scots,25000000,16468499,46734733,63203232,38203232,1.52812928,2018,12
61,1946-12-20,Itâs a Wonderful Life,3180000,6600000,10768908,17368908,14188908,4.4619207547169815,1946,12
61,1951-07-17,Show Boat,2300000,11000000,11000000,22000000,19700000,8.565217391304348,1951,7
61,1976-06-25,Silent Movie,4400000,36145695,36145695,72291390,67891390,15.429861363636364,1976,6
61,1984-02-17,Footloose,8200000,80000000,80000000,160000000,151800000,18.51219512195122,1984,2
61,1987-02-27,A Nightmare On Elm Street 3: Dream Warriors,5000000,44793222,44793222,89586444,84586444,16.9172888,1987,2
61,1988-04-01,"Bright Lights, Big City",25000000,16118077,16118077,32236154,7236154,0.28944616,1988,4
61,1989-04-21,Pet Sematary,11500000,57469179,57469179,114938358,103438358,8.994639826086956,1989,4
61,1992-11-18,Malcolm X,35000000,48169910,48169910,96339820,61339820,1.7525662857142856,1992,11
61,1993-11-24,Mrs. Doubtfire,25000000,219195051,441286003,660481054,635481054,25.41924216,1993,11
61,1995-07-07,First Knight,75000000,37361412,127361412,164722824,89722824,1.19630432,1995,7
61,1997-06-06,Con Air,80000000,101117573,224117573,325235146,245235146,3.065439325,1997,6
61,1997-12-19,Mouse Hunt,38000000,61894591,61894591,123789182,85789182,2.2576100526315788,1997,12
61,1998-05-22,Fear and Loathing in Las Vegas,18500000,10680275,13711903,24392178,5892178,0.31849610810810813,1998,5
61,1998-10-02,Antz,60000000,90757863,152457863,243215726,183215726,3.0535954333333333,1998,10
61,1998-10-23,Orgazmo,1000000,582024,627287,1209311,209311,0.209311,1998,10
61,1999-02-26,8MM,40000000,36443442,96398826,132842268,92842268,2.3210567,1999,2
61,1999-05-28,The Thirteenth Floor,16000000,11810854,11810854,23621708,7621708,0.47635675,1999,5
61,1999-11-05,The Insider,68000000,28965197,60265197,89230394,21230394,0.31221167647058823,1999,11
61,2000-01-21,The Boondock Saints,7000000,30471,411874,442345,-6557655,-0.9368078571428572,2000,1
61,2000-04-05,Black and White,10000000,5241315,5241315,10482630,482630,0.048263,2000,4
61,2000-11-10,You Can Count on Me,1200000,9180275,10827356,20007631,18807631,15.673025833333334,2000,11
61,2000-12-22,Dracula 2000,28000000,33000377,33000377,66000754,38000754,1.3571697857142857,2000,12
61,2001-05-18,Moulin Rouge,53000000,57386369,179200588,236586957,183586957,3.4639048490566036,2001,5
61,2002-06-21,Minority Report,102000000,132024714,358824714,490849428,388849428,3.812249294117647,2002,6
61,2002-07-17,Eight Legged Freaks,30000000,17266505,36722311,53988816,23988816,0.7996272,2002,7
61,2002-12-20,Narc,7500000,10465659,11843260,22308919,14808919,1.9745225333333334,2002,12
61,2003-01-10,The Slaughter Rule,500000,13134,13134,26268,-473732,-0.947464,2003,1
61,2003-03-28,Raising Victor Vargas,800000,2073984,2900578,4974562,4174562,5.2182025,2003,3
61,2003-07-18,This Thing of Ours,2000000,37227,37227,74454,-1925546,-0.962773,2003,7
61,2003-08-29,Party Monster,5000000,742898,894030,1636928,-3363072,-0.6726144,2003,8
61,2003-11-26,The Haunted Mansion,90000000,75817994,155750628,231568622,141568622,1.572984688888889,2003,11
61,2004-06-25,The Notebook,30000000,81001787,116025023,197026810,167026810,5.567560333333334,2004,6
61,2004-08-11,The Princess Diaries 2: Royal Engagement,45000000,95149435,122071435,217220870,172220870,3.8271304444444443,2004,8
61,2004-12-17,Beyond the Sea,24000000,6144806,8292914,14437720,-9562280,-0.39842833333333333,2004,12
61,2004-12-22,Hotel Rwanda,17500000,23519128,36521223,60040351,42540351,2.4308772,2004,12
61,2005-09-16,Proof,20000000,7535331,8284331,15819662,-4180338,-0.2090169,2005,9
61,2005-09-16,Lord of War,42000000,24149632,60437727,84587359,42587359,1.013984738095238,2005,9
61,2005-11-04,I Love Your Work,1600000,3264,3264,6528,-1593472,-0.99592,2005,11
61,2006-11-03,Volver,9400000,12899867,87226613,100126480,90726480,9.651753191489362,2006,11
61,2007-12-14,I am Legend,150000000,256393010,585532684,841925694,691925694,4.61283796,2007,12
61,2009-05-21,Terminator Salvation,200000000,125322469,365491792,490814261,290814261,1.454071305,2009,5
61,2010-04-02,Breaking Upwards,15000,115592,115592,231184,216184,14.412266666666667,2010,4
61,2010-10-15,Hereafter,50000000,32746941,108660270,141407211,91407211,1.82814422,2010,10
61,2011-07-15,Harry Potter and the Deathly Hallows: Part II,125000000,381193157,1341693157,1722886314,1597886314,12.783090512,2011,7
61,2012-01-20,Red Tails,58000000,49876377,50365498,100241875,42241875,0.7283081896551724,2012,1
61,2013-04-12,Scary Movie V,20000000,32015787,78613981,110629768,90629768,4.5314884,2013,4
61,2014-07-18,Wish I Was Here,6000000,3591299,6591365,10182664,4182664,0.6971106666666667,2014,7
61,2014-08-27,The November Man,15000000,25018119,34820335,59838454,44838454,2.9892302666666666,2014,8
61,2014-10-10,St. Vincent,13000000,44137712,54837234,98974946,85974946,6.613457384615384,2014,10
61,2015-04-10,The Longest Ride,34000000,37446117,63802928,101249045,67249045,1.9779130882352942,2015,4
61,2015-08-21,Top Spin,150000,5858,5858,11716,-138284,-0.9218933333333333,2015,8
61,2017-10-27,Jigsaw,10000000,38052832,102445196,140498028,130498028,13.0498028,2017,10
61,2018-05-04,Overboard,12000000,50316123,85369830,135685953,123685953,10.30716275,2018,5
61,2019-04-05,Pet Sematary,21000000,54724696,109501146,164225842,143225842,6.82027819047619,2019,4
62,1951-07-03,Strangers on a Train,1200000,7000000,7000000,14000000,12800000,10.666666666666666,1951,7
62,1982-06-25,Blade Runner,28000000,32656328,39342912,71999240,43999240,1.5714014285714286,1982,6
62,1988-12-16,Rain Man,25000000,172825435,412800000,585625435,560625435,22.4250174,1988,12
62,1993-05-28,Super Mario Bros.,42000000,20844907,20844907,41689814,-310186,-0.007385380952380952,1993,5
62,1993-09-17,The Age of Innocence,34000000,32014993,32014993,64029986,30029986,0.8832348823529412,1993,9
62,1993-10-01,Ruby in Paradise,800000,1001437,1001437,2002874,1202874,1.5035925,1993,10
62,1994-10-14,Pulp Fiction,8000000,107928762,212928762,320857524,312857524,39.1071905,1994,10
62,1996-05-03,The Craft,15000000,24769466,55669466,80438932,65438932,4.362595466666667,1996,5
62,1996-07-19,Trainspotting,3100000,16501785,71558971,88060756,84960756,27.40669548387097,1996,7
62,1996-07-19,Fled,30000000,17192205,19892205,37084410,7084410,0.236147,1996,7
62,1997-12-25,Jackie Brown,12000000,39673162,74727492,114400654,102400654,8.533387833333334,1997,12
62,1998-05-01,"Dancer, Texas Pop. 81",2300000,574838,574838,1149676,-1150324,-0.5001408695652174,1998,5
62,1999-06-30,"South Park: Bigger, Longer & Uncut",21000000,52037603,52037603,104075206,83075206,3.9559621904761904,1999,6
62,2000-08-04,Hollow Man,90000000,73209340,191200000,264409340,174409340,1.9378815555555555,2000,8
62,2001-08-31,Jeepers Creepers,10000000,37904175,58939035,96843210,86843210,8.684321,2001,8
62,2001-11-02,Domestic Disturbance,53000000,45207112,54207112,99414224,46414224,0.8757400754716981,2001,11
62,2002-04-19,Murder by Numbers,50000000,31874869,56643267,88518136,38518136,0.77036272,2002,4
62,2002-04-19,The Scorpion King,60000000,90580000,165890634,256470634,196470634,3.2745105666666667,2002,4
62,2002-11-15,Half Past Dead,25000000,15567860,19233280,34801140,9801140,0.3920456,2002,11
62,2004-09-03,The Cookout,16000000,11540112,11540112,23080224,7080224,0.442514,2004,9
62,2005-06-10,Hauru no ugoku shiro,24000000,4710455,237814327,242524782,218524782,9.10519925,2005,6
62,2005-09-16,Just Like Heaven,58000000,48318130,100687083,149005213,91005213,1.5690553965517242,2005,9
62,2005-10-21,Shopgirl,7500000,10284523,11758418,22042941,14542941,1.9390588,2005,10
62,2006-07-14,The Oh in Ohio,5000000,418689,648183,1066872,-3933128,-0.7866256,2006,7
62,2006-08-25,Beerfest,17500000,19185184,20159316,39344500,21844500,1.248257142857143,2006,8
62,2006-12-21,Venus,6000000,3347411,7818479,11165890,5165890,0.8609816666666666,2006,12
62,2007-12-25,The Bucket List,45000000,93466502,174807445,268273947,223273947,4.961643266666667,2007,12
62,2008-07-04,Ne le dis Ã personne,18500000,6198883,33954018,40152901,21652901,1.170427081081081,2008,7
62,2008-10-03,An American Carol,20000000,7013191,7022183,14035374,-5964626,-0.2982313,2008,10
62,2009-04-10,Hannah Montana the Movie,30000000,79576189,169173206,248749395,218749395,7.2916465,2009,4
62,2010-03-12,She's Out of My League,20000000,32010860,48680977,80691837,60691837,3.03459185,2010,3
62,2010-05-14,The Living Wake,500000,12232,12232,24464,-475536,-0.951072,2010,5
62,2010-06-18,Io sono lâamore,10000000,5005465,15121528,20126993,10126993,1.0126993,2010,6
62,2010-12-17,Yogi Bear,80000000,100246011,204774690,305020701,225020701,2.8127587625,2010,12
62,2011-03-25,Sucker Punch,75000000,36392502,89758389,126150891,51150891,0.68201188,2011,3
62,2011-06-17,Green Lantern,200000000,116601172,219535492,336136664,136136664,0.68068332,2011,6
62,2011-07-29,The Future,1000000,568662,1239174,1807836,807836,0.807836,2011,7
62,2011-11-11,Melancholia,9400000,3030848,21817298,24848146,15448146,1.6434197872340426,2011,11
62,2013-08-30,No se Aceptan Devoluciones,5000000,44467206,100486616,144953822,139953822,27.9907644,2013,8
62,2014-07-02,Earth to Echo,13000000,38934842,42174545,81109387,68109387,5.239183615384615,2014,7
62,2014-11-21,The Hunger Games: Mockingjay - Part 1,125000000,337135885,766575131,1103711016,978711016,7.829688128,2014,11
62,2015-05-22,Poltergeist,35000000,47425125,95713069,143138194,108138194,3.089662685714286,2015,5
62,2015-10-09,Knock Knock,2000000,36336,6328516,6364852,4364852,2.182426,2015,10
62,2016-01-22,Dirty Grandpa,11500000,35593113,105078449,140671562,129171562,11.232309739130434,2016,1
62,2016-11-23,Moana,150000000,248757044,637517365,886274409,736274409,4.90849606,2016,11
62,2016-12-23,Why Him?,38000000,60323786,117425156,177748942,139748942,3.677603736842105,2016,12
62,2017-12-22,Downsizing,68000000,24449754,54462971,78912725,10912725,0.16048125,2017,12
62,2018-01-12,The Commuter,40000000,36343858,101985431,138329289,98329289,2.458232225,2018,1
62,2018-12-21,Bumblebee,102000000,127195589,465195589,592391178,490391178,4.807756647058824,2018,12
63,1955-10-03,The Trouble with Harry,1200000,7000000,7000000,14000000,12800000,10.666666666666666,1955,10
63,1979-10-19,Meteor,16000000,8400000,8400000,16800000,800000,0.05,1979,10
63,1981-08-07,Heavy Metal,9300000,19571091,19571091,39142182,29842182,3.208836774193548,1981,8
63,1982-06-18,Firefox,21000000,45785720,45785720,91571440,70571440,3.360544761904762,1982,6
63,1983-11-18,Yentl,12000000,39012241,39012241,78024482,66024482,5.502040166666666,1983,11
63,1984-03-09,The Hotel New Hampshire,7500000,5142858,5142858,10285716,2785716,0.3714288,1984,3
63,1984-06-22,The Karate Kid,8000000,90815558,90815558,181631116,173631116,21.7038895,1984,6
63,1985-06-28,St. Elmoâs Fire,10000000,37800000,37800000,75600000,65600000,6.56,1985,6
63,1986-04-18,Legend,25000000,15502112,23506237,39008349,14008349,0.56033396,1986,4
63,1992-10-02,Hero,42000000,19487173,66787173,86274346,44274346,1.0541510952380952,1992,10
63,1994-07-20,The Client,45000000,92115211,117615211,209730422,164730422,3.6606760444444446,1994,7
63,1995-04-07,Rob Roy,28000000,31390587,31390587,62781174,34781174,1.2421847857142858,1995,4
63,1995-10-06,Assassins,50000000,30306268,83306268,113612536,63612536,1.27225072,1995,10
63,1996-02-21,Bottle Rocket,5000000,407488,407488,814976,-4185024,-0.8370048,1996,2
63,1997-04-11,Pink Flamingos,12000,413802,413802,827604,815604,67.967,1997,4
63,1998-03-27,Meet the Deedles,24000000,4356126,4356126,8712252,-15287748,-0.6369895,1998,3
63,1999-03-31,10 Things I Hate About You,13000000,38177966,60413950,98591916,85591916,6.583993538461539,1999,3
63,2000-02-18,Hanging Up,40000000,36037909,51867723,87905632,47905632,1.1976408,2000,2
63,2001-02-02,Left Behind,18500000,4221341,4221341,8442682,-10057318,-0.5436388108108108,2001,2
63,2001-10-26,On the Line,10000000,4365455,4690802,9056257,-943743,-0.0943743,2001,10
63,2001-11-16,Harry Potter and the Sorcererâs Stone,125000000,317871467,975047606,1292919073,1167919073,9.343352584,2001,11
63,2002-08-09,Pandora's Box,800000,881950,881950,1763900,963900,1.204875,2002,8
63,2003-02-14,All the Real Girls,1000000,549666,703020,1252686,252686,0.252686,2003,2
63,2003-03-14,Willard,20000000,6882696,6882696,13765392,-6234608,-0.3117304,2003,3
63,2003-12-25,Cold Mountain,80000000,95632614,165173909,260806523,180806523,2.2600815375,2003,12
63,2005-03-11,Hostage,75000000,34636443,77636443,112272886,37272886,0.49697181333333335,2005,3
63,2005-04-22,The Interpreter,90000000,72708161,162753837,235461998,145461998,1.6162444222222223,2005,4
63,2005-12-28,Match Point,15000000,23089926,87973835,111063761,96063761,6.404250733333333,2005,12
63,2006-10-20,Flags of Our Fathers,53000000,33602376,63657941,97260317,44260317,0.835100320754717,2006,10
63,2008-01-18,27 Dresses,30000000,76808654,160247805,237056459,207056459,6.901881966666667,2008,1
63,2008-07-01,Hancock,150000000,227946274,624234272,852180546,702180546,4.68120364,2008,7
63,2008-11-26,Milk,20000000,31841299,57293371,89134670,69134670,3.4567335,2008,11
63,2009-02-27,Scott Walker: 30 Century Man,500000,6840,77121,83961,-416039,-0.832078,2009,2
63,2009-08-14,Gake no ue no Ponyo,34000000,15090399,205312666,220403065,186403065,5.482443088235294,2009,8
63,2010-05-28,Prince of Persia: Sands of Time,200000000,90759676,336359676,427119352,227119352,1.13559676,2010,5
63,2010-06-04,Splice,30000000,17010170,28542494,45552664,15552664,0.5184221333333333,2010,6
63,2010-10-15,Red,60000000,90380162,196439693,286819855,226819855,3.7803309166666668,2010,10
63,2011-04-01,Insidious,1500000,54009150,99870886,153880036,152380036,101.58669066666667,2011,4
63,2011-04-22,Water for Elephants,38000000,58709717,116809717,175519434,137519434,3.6189324736842106,2011,4
63,2011-08-10,The Help,25000000,169705587,213120004,382825591,357825591,14.31302364,2011,8
63,2012-03-02,Doctor Seuss' The Lorax,67500000,214030500,350976753,565007253,497507253,7.370477822222222,2012,3
63,2012-10-26,Cloud Atlas,102000000,27108272,130673154,157781426,55781426,0.5468767254901961,2012,10
63,2013-06-07,The Internship,58000000,44672764,93672764,138345528,80345528,1.385267724137931,2013,6
63,2013-11-27,Black Nativity,17500000,7018188,7285135,14303323,-3196677,-0.18266725714285714,2013,11
63,2014-03-14,Veronica Mars,6000000,3322127,3485383,6807510,807510,0.134585,2014,3
63,2014-09-05,Frontera,2300000,59696,59696,119392,-2180608,-0.9480904347826087,2014,9
63,2015-08-07,The Gift,5000000,43787265,58978477,102765742,97765742,19.5531484,2015,8
63,2017-02-03,Growing up Smith,2000000,35312,35312,70624,-1929376,-0.964688,2017,2
63,2018-10-12,Goosebumps 2: Haunted Halloween,35000000,46697321,93291478,139988799,104988799,2.9996799714285713,2018,10
64,1967-12-29,"Il buono, il brutto, il cattivo",1200000,6100000,6100000,12200000,11000000,9.166666666666666,1967,12
64,1968-12-11,Oliver!,10000000,37402877,37402877,74805754,64805754,6.4805754,1968,12
64,1969-10-15,Paint Your Wagon,20000000,31678778,31678778,63357556,43357556,2.1678778,1969,10
64,1978-07-28,National Lampoon's Animal House,3000000,141600000,141600000,283200000,280200000,93.4,1978,7
64,1979-06-22,The Muppet Movie,8000000,76657000,76657000,153314000,145314000,18.16425,1979,6
64,1986-03-07,Highlander,16000000,5900000,12900000,18800000,2800000,0.175,1986,3
64,1991-03-01,The Doors,40000000,34416893,34416893,68833786,28833786,0.72084465,1991,3
64,1993-08-27,Only the Strong,6000000,3273588,3273588,6547176,547176,0.091196,1993,8
64,1993-11-05,The Remains of the Day,15000000,22954968,63954968,86909936,71909936,4.793995733333333,1993,11
64,1995-08-25,The Thief and the Cobbler,24000000,669276,669276,1338552,-22661448,-0.944227,1995,8
64,1996-07-26,The Adventures of Pinocchio,25000000,15382170,36682170,52064340,27064340,1.0825736,1996,7
64,2000-04-28,The Flintstones in Viva Rock Vegas,58000000,35231365,59431365,94662730,36662730,0.6321160344827587,2000,4
64,2000-11-17,Rugrats in Paris,30000000,76501438,103284813,179786251,149786251,4.992875033333333,2000,11
64,2002-03-08,Men with Brooms,7500000,4239767,4239767,8479534,979534,0.13060453333333333,2002,3
64,2002-05-10,The New Guy,13000000,28972187,28972187,57944374,44944374,3.4572595384615386,2002,5
64,2002-11-15,Harry Potter and the Chamber of Secrets,100000000,262233381,879225135,1141458516,1041458516,10.41458516,2002,11
64,2003-04-25,City of Ghosts,17500000,325491,325491,650982,-16849018,-0.9628010285714286,2003,4
64,2004-03-05,Starsky & Hutch,60000000,88200225,170200225,258400450,198400450,3.306674166666667,2004,3
64,2005-07-15,Charlie and the Chocolate Factory,150000000,206459076,475825484,682284560,532284560,3.5485637333333333,2005,7
64,2005-10-21,The Californians,500000,4134,4134,8268,-491732,-0.983464,2005,10
64,2006-04-28,Grip: A Criminal's Story,12000,1336,1336,2672,-9328,-0.7773333333333333,2006,4
64,2007-04-06,Grindhouse,53000000,25031037,50187789,75218826,22218826,0.4192231320754717,2007,4
64,2007-07-18,Cama adentro,800000,200433,200433,400866,-399134,-0.4989175,2007,7
64,2008-02-01,Strange Wilderness,20000000,6575282,6947084,13522366,-6477634,-0.3238817,2008,2
64,2008-04-18,88 Minutes,30000000,16930884,32955399,49886283,19886283,0.6628761,2008,4
64,2008-04-25,Harold & Kumar Escape from Guantanamo Bay,12000000,38108728,43353117,81461845,69461845,5.788487083333333,2008,4
64,2008-10-10,Body of Lies,67500000,39394666,118556530,157951196,90451196,1.3400177185185185,2008,10
64,2009-03-20,Super Capers,2000000,30955,30955,61910,-1938090,-0.969045,2009,3
64,2009-10-09,St. Trinianâs,11400000,15000,29830239,29845239,18445239,1.6180034210526315,2009,10
64,2010-01-15,The Book of Eli,80000000,94835059,158750817,253585876,173585876,2.16982345,2010,1
64,2010-04-16,Death at a Funeral,21000000,42739347,48977233,91716580,70716580,3.3674561904761906,2010,4
64,2010-10-08,Life as We Know It,38000000,53374681,105887837,159262518,121262518,3.1911188947368423,2010,10
64,2010-11-19,Harry Potter and the Deathly Hallows: Part I,125000000,296131568,960431568,1256563136,1131563136,9.052505088,2010,11
64,2011-06-29,Transformers: Dark of the Moon,195000000,352390543,1123790543,1476181086,1281181086,6.570159415384615,2011,6
64,2011-08-26,Redemption Road,2300000,29384,29384,58768,-2241232,-0.974448695652174,2011,8
64,2011-11-23,The Muppets,45000000,88625922,160971922,249597844,204597844,4.5466187555555555,2011,11
64,2012-01-27,Man on a Ledge,42000000,18620000,49621440,68241440,26241440,0.6247961904761905,2012,1
64,2012-11-13,Jab Tak Hai Jaan,9200000,3047539,5806666,8854205,-345795,-0.03758641304347826,2012,11
64,2013-08-07,Percy Jackson: Sea of Monsters,90000000,68559554,200859554,269419108,179419108,1.9935456444444444,2013,8
64,2013-08-16,Ain't Them Bodies Saints,5000000,391611,1075009,1466620,-3533380,-0.706676,2013,8
64,2014-02-21,3 Days to Kill,28000000,30697999,38959900,69657899,41657899,1.4877821071428572,2014,2
64,2014-05-09,Neighbors,18000000,150086800,270944428,421031228,403031228,22.390623777777776,2014,5
64,2014-10-24,23 Blast,1000000,549185,549185,1098370,98370,0.09837,2014,10
64,2016-02-12,Zoolander 2,50000000,28848693,55348693,84197386,34197386,0.68394772,2016,2
64,2016-10-21,Moonlight,1500000,27854931,65245512,93100443,91600443,61.066962,2016,10
64,2016-10-28,Inferno,75000000,34343574,219519367,253862941,178862941,2.384839213333333,2016,10
64,2016-12-25,Hidden Figures,25000000,169607287,231771716,401379003,376379003,15.05516012,2016,12
64,2017-06-23,The Big Sick,5000000,42872467,53972860,96845327,91845327,18.3690654,2017,6
64,2018-01-19,12 Strong,35000000,45819713,71118378,116938091,81938091,2.3410883142857144,2018,1
64,2018-06-15,Gotti,10000000,4286367,6089100,10375467,375467,0.0375467,2018,6
64,2018-08-03,The Darkest Minds,34000000,12695691,38361428,51057119,17057119,0.5016799705882353,2018,8
65,1951-09-18,The Day the Earth Stood Still,1200000,3700000,3700000,7400000,6200000,5.166666666666667,1951,9
65,1975-05-16,The Return of the Pink Panther,5000000,41833347,41833347,83666694,78666694,15.7333388,1975,5
65,1977-05-25,Star Wars Ep. IV: A New Hope,11000000,460998007,786598007,1247596014,1236596014,112.41781945454545,1977,5
65,1984-03-09,Splash,8000000,62599495,62599495,125198990,117198990,14.64987375,1984,3
65,1990-06-27,Days of Thunder,60000000,82670733,157670733,240341466,180341466,3.0056911,1990,6
65,1991-07-02,Terminator 2: Judgment Day,100000000,203464105,515419827,718883932,618883932,6.18883932,1991,7
65,1992-06-05,Patriot Games,45000000,83287363,178100000,261387363,216387363,4.808608066666666,1992,6
65,1993-01-01,Return of the Living Dead 3,2000000,21000,21000,42000,-1958000,-0.979,1993,1
65,1993-01-15,Nowhere to Run,15000000,22189039,52189039,74378078,59378078,3.9585385333333334,1993,1
65,1993-02-05,Loaded Weapon 1,13000000,27979399,27979399,55958798,42958798,3.304522923076923,1993,2
65,1993-02-12,Groundhog Day,14600000,70906973,70906973,141813946,127213946,8.71328397260274,1993,2
65,1993-03-19,Teenage Mutant Ninja Turtles III,21000000,42273609,42273609,84547218,63547218,3.026058,1993,3
65,1995-12-29,Richard III,9200000,2684904,4199334,6884238,-2315762,-0.2517132608695652,1995,12
65,1997-01-17,Albino Alligator,5000000,353480,353480,706960,-4293040,-0.858608,1997,1
65,1997-06-20,Dream With The Fishes,1000000,542909,542909,1085818,85818,0.085818,1997,6
65,1997-11-26,Flubber,80000000,92993801,177993801,270987602,190987602,2.387345025,1997,11
65,1998-10-16,Beloved,53000000,22852487,22852487,45704974,-7295026,-0.137642,1998,10
65,1999-08-20,Mickey Blue Eyes,40000000,33864342,53864342,87728684,47728684,1.1932171,1999,8
65,1999-09-01,Chill Factor,34000000,11263966,11263966,22527932,-11472068,-0.33741376470588236,1999,9
65,1999-12-29,The Hurricane,38000000,50699241,73956241,124655482,86655482,2.2804074210526317,1999,12
65,2000-03-10,Deterrence,800000,144583,371647,516230,-283770,-0.3547125,2000,3
65,2001-02-16,Recess: School's Out,10000000,36696761,44451470,81148231,71148231,7.1148231,2001,2
65,2001-07-20,Hedwig and the Angry Inch,6000000,3067312,3740030,6807342,807342,0.134557,2001,7
65,2003-06-06,Whale Rider,4300000,20779666,39374600,60154266,55854266,12.989364186046512,2003,6
65,2003-06-13,Hollywood Homicide,75000000,30207785,50409753,80617538,5617538,0.07490050666666667,2003,6
65,2003-07-25,Lara Croft: Tomb Raider: The Cradle of Life,90000000,65653758,157092943,222746701,132746701,1.4749633444444445,2003,7
65,2003-09-12,Cabin Fever,1500000,21158188,30351664,51509852,50009852,33.33990133333333,2003,9
65,2004-04-09,The Whole Ten Yards,30000000,16323969,26323969,42647938,12647938,0.42159793333333334,2004,4
65,2005-06-10,The Bridge of San Luis Rey,24000000,49981,1696765,1746746,-22253254,-0.9272189166666667,2005,6
65,2005-09-30,The Greatest Game Ever Played,25000000,15331289,15468266,30799555,5799555,0.2319822,2005,9
65,2006-05-19,The Da Vinci Code,125000000,217536138,767820459,985356597,860356597,6.882852776,2006,5
65,2006-11-03,Borat,18000000,128505958,261443242,389949200,371949200,20.663844444444443,2006,11
65,2007-06-29,Ratatouille,150000000,206445654,626549695,832995349,682995349,4.553302326666667,2007,6
65,2008-02-22,Witless Protection,7500000,4151836,4151836,8303672,803672,0.10715626666666667,2008,2
65,2008-04-04,Leatherheads,58000000,31373938,41348628,72722566,14722566,0.2538373448275862,2008,4
65,2008-12-12,Gran Torino,25000000,148095302,274543085,422638387,397638387,15.90553548,2008,12
65,2009-01-16,Defiance,50000000,28644813,52987754,81632567,31632567,0.63265134,2009,1
65,2009-01-23,Underworld 3: Rise of the Lycans,35000000,45802315,89102315,134904630,99904630,2.854418,2009,1
65,2010-10-20,Paranormal Activity 2,3000000,84752907,177512032,262264939,259264939,86.42164633333333,2010,10
65,2010-12-03,The Warrior's Way,42000000,5666340,8514325,14180665,-27819335,-0.6623651190476191,2010,12
65,2011-08-31,The Debt,20000000,31177548,46604054,77781602,57781602,2.8890801,2011,8
65,2012-03-16,"Jeff, Who Lives at Home",10000000,4269426,4708127,8977553,-1022447,-0.1022447,2012,3
65,2012-06-22,Abraham Lincoln: Vampire Hunter,67500000,37519139,137489730,175008869,107508869,1.592723985185185,2012,6
65,2013-08-16,Kick-Ass 2,28000000,28795985,63129909,91925894,63925894,2.283067642857143,2013,8
65,2013-11-22,Philomena,12000000,37709979,98963392,136673371,124673371,10.389447583333334,2013,11
65,2014-09-10,Born to Fly: Elizabeth Streb vs. Gravity,500000,1822,1822,3644,-496356,-0.992712,2014,9
65,2015-04-24,Little Boy,20000000,6485961,17769299,24255260,4255260,0.212763,2015,4
65,2016-11-18,Bleed for This,16000000,5083906,6603926,11687832,-4312168,-0.2695105,2016,11
65,2017-06-09,The Mummy,195000000,80101125,409953905,490055030,295055030,1.513102717948718,2017,6
65,2017-08-18,The Hitmanâs Bodyguard,30000000,75468583,172778667,248247250,218247250,7.274908333333333,2017,8
66,1974-10-18,The Texas Chainsaw Massacre,140000,26572439,26572439,53144878,53004878,378.6062714285714,1974,10
66,1981-11-06,Time Bandits,12000000,37400000,37400000,74800000,62800000,5.233333333333333,1981,11
66,1984-06-08,Gremlins,11000000,148168459,148199515,296367974,285367974,25.94254309090909,1984,6
66,1985-07-10,Mad Max Beyond Thunderdome,10000000,36230219,36230219,72460438,62460438,6.2460438,1985,7
66,1986-08-01,Howard the Duck,30000000,16295774,16295774,32591548,2591548,0.08638493333333333,1986,8
66,1991-12-25,The Prince of Tides,30000000,74787599,74787599,149575198,119575198,3.985839933333333,1991,12
66,1994-07-29,The Mask,18000000,119920129,351620129,471540258,453540258,25.196681,1994,7
66,1995-06-16,Batman Forever,100000000,184031112,336529144,520560256,420560256,4.20560256,1995,6
66,1996-09-20,Last Man Standing,67000000,18115927,18115927,36231854,-30768146,-0.45922605970149255,1996,9
66,1997-04-18,McHale's Navy,42000000,4408420,4408420,8816840,-33183160,-0.790075238095238,1997,4
66,1999-03-12,Baby Geniuses,13000000,27151490,27151490,54302980,41302980,3.1771523076923076,1999,3
66,1999-07-23,The Haunting,80000000,91188905,180188905,271377810,191377810,2.392222625,1999,7
66,1999-08-27,The Astronaut's Wife,34000000,10672566,10672566,21345132,-12654868,-0.372202,1999,8
66,1999-12-17,Topsy Turvy,20000000,6201757,6201757,12403514,-7596486,-0.3798243,1999,12
66,2000-06-16,Titan A.E.,75000000,22751979,36751979,59503958,-15496042,-0.20661389333333333,2000,6
66,2000-09-22,Urban Legends: Final Cut,15000000,21468807,38574362,60043169,45043169,3.0028779333333335,2000,9
66,2000-10-20,Pay it Forward,40000000,33508922,55696705,89205627,49205627,1.230140675,2000,10
66,2001-03-09,Dayereh,10000,673780,673780,1347560,1337560,133.756,2001,3
66,2001-06-13,Sexy Beast,4300000,6946056,10158355,17104411,12804411,2.97777,2001,6
66,2001-09-14,Hardball,21000000,40222729,43728560,83951289,62951289,2.9976804285714285,2001,9
66,2002-05-03,Hollywood Ending,16000000,4839383,14839383,19678766,3678766,0.229922875,2002,5
66,2002-10-25,Ghost Ship,20000000,30113491,68349884,98463375,78463375,3.92316875,2002,10
66,2003-05-02,X-Men 2,125000000,214949694,406875536,621825230,496825230,3.97460184,2003,5
66,2003-10-31,Shattered Glass,6000000,2207975,3456602,5664577,-335423,-0.05590383333333333,2003,10
66,2004-05-07,The Mudge Boy,800000,62544,62544,125088,-674912,-0.84364,2004,5
66,2004-11-24,The Work and the Glory,7500000,3347647,3347647,6695294,-804706,-0.10729413333333333,2004,11
66,2005-05-13,Monster-in-Law,45000000,82931301,155931301,238862602,193862602,4.3080578222222226,2005,5
66,2005-07-29,Must Love Dogs,35000000,43894863,58405313,102300176,67300176,1.9228621714285714,2005,7
66,2005-12-21,Cheaper by the Dozen 2,60000000,82571173,135015330,217586503,157586503,2.6264417166666667,2005,12
66,2006-07-26,Little Miss Sunshine,8000000,59891098,100642353,160533451,152533451,19.066681375,2006,7
66,2007-02-09,Hannibal Rising,50000000,27669725,80583311,108253036,58253036,1.16506072,2007,2
66,2007-05-02,Waitress,1500000,19097550,22217183,41314733,39814733,26.543155333333335,2007,5
66,2007-10-12,We Own the Night,28000000,28563179,55307857,83871036,55871036,1.995394142857143,2007,10
66,2009-01-30,Taken,25000000,145000989,226941585,371942574,346942574,13.87770296,2009,1
66,2009-11-06,The Box,25000000,15051977,34356760,49408737,24408737,0.97634948,2009,11
66,2009-11-20,The Missing Person,2000000,17896,17896,35792,-1964208,-0.982104,2009,11
66,2010-05-21,Kites,9200000,1685269,17155193,18840462,9640462,1.047876304347826,2010,5
66,2012-12-19,Zero Dark Thirty,52500000,95720716,134612435,230333151,177833151,3.387298114285714,2012,12
66,2013-03-01,Jack the Giant Slayer,195000000,65187603,197687603,262875206,67875206,0.3480779794871795,2013,3
66,2013-04-19,Home Run,1200000,2859955,2859955,5719910,4519910,3.766591666666667,2013,4
66,2013-06-28,Detention of the Dead,500000,1778,1778,3556,-496444,-0.992888,2013,6
66,2013-07-19,The Act of Killing,1000000,486919,1227316,1714235,714235,0.714235,2013,7
66,2013-09-06,Riddick,38000000,42025135,94763758,136788893,98788893,2.599707710526316,2013,9
66,2013-11-08,Thor: The Dark World,150000000,206362140,644602516,850964656,700964656,4.673097706666667,2013,11
66,2014-09-26,Jimi: All is By My Side,5000000,340911,927074,1267985,-3732015,-0.746403,2014,9
66,2015-07-01,Magic Mike XXL,14500000,66013057,123660597,189673654,175173654,12.080941655172413,2015,7
66,2015-08-28,War Room,3000000,67790117,73975239,141765356,138765356,46.25511866666667,2015,8
66,2016-06-10,Now You See Me 2,90000000,65075540,328325007,393400547,303400547,3.371117188888889,2016,6
66,2016-09-30,Denial,10000000,4073448,9263940,13337388,3337388,0.3337388,2016,9
66,2017-03-24,Life,58000000,30234022,100929666,131163688,73163688,1.2614428965517241,2017,3
66,2018-04-06,A Quiet Place,17000000,188024361,334522294,522546655,505546655,29.738038529411764,2018,4
66,2019-05-31,MA,5000000,36049540,44300625,80350165,75350165,15.070033,2019,5
67,1953-09-16,The Robe,5000000,36000000,36008303,72008303,67008303,13.4016606,1953,9
67,1965-12-22,Doctor Zhivago,11000000,111897830,112036323,223934153,212934153,19.357650272727273,1965,12
67,1977-11-03,Peteâs Dragon,10000000,36000000,36000000,72000000,62000000,6.2,1977,11
67,1988-06-03,Big,18000000,114968774,151668774,266637548,248637548,13.81319711111111,1988,6
67,1989-09-08,Kickboxer,1500000,14533681,14533681,29067362,27567362,18.37824133333333,1989,9
67,1989-12-20,Roger & Me,140000,6706368,6706368,13412736,13272736,94.80525714285714,1989,12
67,1992-10-23,Reservoir Dogs,1200000,2832029,2832029,5664058,4464058,3.720048333333333,1992,10
67,1996-11-01,Romeo+Juliet,14500000,46338728,147542381,193881109,179381109,12.371110965517241,1996,11
67,1996-11-15,Space Jam,80000000,90463534,250200000,340663534,260663534,3.258294175,1996,11
67,1998-04-24,The Big Hit,13000000,27066941,27066941,54133882,41133882,3.164144769230769,1998,4
67,1999-10-15,The Story of Us,50000000,27100030,27100030,54200060,4200060,0.0840012,1999,10
67,2000-03-03,The Next Best Thing,25000000,14983572,24355762,39339334,14339334,0.57357336,2000,3
67,2000-05-05,I Dreamed of Africa,34000000,6543194,14291999,20835193,-13164807,-0.38720020588235293,2000,5
67,2000-09-15,Duets,16000000,4734235,6615452,11349687,-4650313,-0.2906445625,2000,9
67,2001-03-23,Heartbreakers,38000000,40334024,57753825,98087849,60087849,1.5812591842105264,2001,3
67,2001-07-27,Planet of the Apes,100000000,180011740,362211740,542223480,442223480,4.4222348,2001,7
67,2001-08-10,The Others,17000000,96522687,207765056,304287743,287287743,16.899279,2001,8
67,2001-10-05,Training Day,45000000,76261036,104505362,180766398,135766398,3.0170310666666666,2001,10
67,2001-11-21,Spy Game,90000000,62362560,143049560,205412120,115412120,1.282356888888889,2001,11
67,2002-02-15,Crossroads,12000000,37188667,57000000,94188667,82188667,6.8490555833333335,2002,2
67,2002-12-25,Catch Me if You Can,52000000,164606800,355612291,520219091,468219091,9.00421328846154,2002,12
67,2003-04-11,The Young Unknowns,800000,58163,58163,116326,-683674,-0.8545925,2003,4
67,2003-05-02,Blue Car,1000000,464126,475367,939493,-60507,-0.060507,2003,5
67,2004-12-17,Flight of the Phoenix,75000000,21009180,34009180,55018360,-19981640,-0.2664218666666667,2004,12
67,2005-06-15,Batman Begins,150000000,205343774,359142722,564486496,414486496,2.763243306666667,2005,6
67,2005-08-12,Four Brothers,30000000,74494381,92494381,166988762,136988762,4.566292066666667,2005,8
67,2006-04-28,Clean,10000,138711,138711,277422,267422,26.7422,2006,4
67,2007-07-03,License to Wed,35000000,43799818,70187088,113986906,78986906,2.256768742857143,2007,7
67,2007-08-03,"Gandhi, My Father",5000000,240425,2015004,2255429,-2744571,-0.5489142,2007,8
67,2007-08-17,The Last Legion,67000000,5932060,25357771,31289831,-35710169,-0.5329875970149254,2007,8
67,2008-07-03,The Wackness,6000000,2077046,3330012,5407058,-592942,-0.09882366666666667,2008,7
67,2008-10-24,Pride and Glory,30000000,15740721,43440721,59181442,29181442,0.9727147333333334,2008,10
67,2009-10-02,Zombieland,23600000,75590286,102236596,177826882,154226882,6.535037372881356,2009,10
67,2009-12-04,Paa,4300000,199228,9791282,9990510,5690510,1.3233744186046512,2009,12
67,2009-12-18,Did You Hear About the Morgans?,58000000,29580087,80480566,110060653,52060653,0.8975974655172414,2009,12
67,2010-01-08,Daybreakers,20000000,30101577,51445503,81547080,61547080,3.077354,2010,1
67,2010-05-28,Micmacs,42000000,1259693,11756922,13016615,-28983385,-0.6900805952380953,2010,5
67,2010-08-13,Eat Pray Love,60000000,80574010,206598789,287172799,227172799,3.7862133166666667,2010,8
67,2010-09-17,Easy A,8000000,58401464,76200721,134602185,126602185,15.825273125,2010,9
67,2010-11-05,For Colored Girls,21000000,37729698,38017873,75747571,54747571,2.6070271904761904,2010,11
67,2011-04-08,Arthur,40000000,33035397,47787943,80823340,40823340,1.0205835,2011,4
67,2011-04-29,Fast Five,125000000,210031325,630163454,840194779,715194779,5.721558232,2011,4
67,2011-12-21,Albert Nobbs,7500000,3014696,8539003,11553699,4053699,0.5404932,2011,12
67,2012-10-19,The First Time,2000000,17061,17061,34122,-1965878,-0.982939,2012,10
67,2012-10-26,Chasing Mavericks,20000000,6002756,8300821,14303577,-5696423,-0.28482115,2012,10
67,2013-03-29,The Place Beyond the Pines,15000000,21403519,47011449,68414968,53414968,3.560997866666667,2013,3
67,2013-06-07,The Purge,3000000,64473115,91266581,155739696,152739696,50.913232,2013,6
67,2014-01-17,Ride Along,25000000,134202565,153733800,287936365,262936365,10.5174546,2014,1
67,2014-09-19,A Walk Among the Tombstones,28000000,26017685,62108587,88126272,60126272,2.147366857142857,2014,9
67,2015-04-03,Furious 7,190000000,353007020,1518722794,1871729814,1681729814,8.851209547368422,2015,4
67,2016-04-29,The Man Who Knew Infinity,10000000,3877922,12382122,16260044,6260044,0.6260044,2016,4
67,2018-05-11,Higher Power,500000,528,528,1056,-498944,-0.997888,2018,5
68,1939-12-15,Gone with the Wind,3900000,198680470,390525192,589205662,585305662,150.07837487179486,1939,12
68,1940-02-09,Pinocchio,2289247,84300000,84300000,168600000,166310753,72.64867137534743,1940,2
68,1964-12-22,Goldfinger,3000000,51100000,124900000,176000000,173000000,57.666666666666664,1964,12
68,1980-05-21,Star Wars Ep. V: The Empire Strikes Back,23000000,290271960,534161334,824433294,801433294,34.84492582608696,1980,5
68,1986-07-18,Aliens,17000000,85160248,183316455,268476703,251476703,14.792747235294117,1986,7
68,1986-08-08,Stand by Me,8000000,52287414,52287414,104574828,96574828,12.0718535,1986,8
68,1988-02-26,Bloodsport,1500000,11806119,11806119,23612238,22112238,14.741492,1988,2
68,1990-11-09,Child's Play 2,13000000,26904572,34166572,61071144,48071144,3.6977803076923075,1990,11
68,1991-09-13,Freddyâs Dead: The Final Nightmare,5000000,34872033,34872033,69744066,64744066,12.9488132,1991,9
68,1992-11-25,The Bodyguard,25000000,121945720,410899039,532844759,507844759,20.31379036,1992,11
68,1994-12-23,Legends of the Fall,30000000,66502573,160502573,227005146,197005146,6.5668382,1994,12
68,1997-02-28,Donnie Brasco,35000000,41954997,65303052,107258049,72258049,2.064515685714286,1997,2
68,1997-04-04,The Saint,90000000,61363304,169400000,230763304,140763304,1.564036711111111,1997,4
68,1998-10-23,Soldier,75000000,14623082,14623082,29246164,-45753836,-0.6100511466666667,1998,10
68,1999-04-30,Entrapment,66000000,87707396,211700000,299407396,233407396,3.536475696969697,1999,4
68,1999-08-13,Detroit Rock City,16000000,4217115,5825314,10042429,-5957571,-0.3723481875,1999,8
68,2000-07-07,But I'm a Cheerleader,1200000,2205627,2509344,4714971,3514971,2.9291425,2000,7
68,2001-07-06,Cure,10000,94596,94596,189192,179192,17.9192,2001,7
68,2001-07-13,Legally Blonde,18000000,96493426,141809235,238302661,220302661,12.239036722222222,2001,7
68,2001-11-16,Novocaine,6000000,2025238,2522928,4548166,-1451834,-0.24197233333333334,2001,11
68,2002-05-24,Enough,38000000,39177215,50970660,90147875,52147875,1.3723125,2002,5
68,2004-11-19,National Treasure,100000000,173005002,331323410,504328412,404328412,4.04328412,2004,11
68,2005-08-26,The Cave,30000000,15007991,27147991,42155982,12155982,0.4051994,2005,8
68,2006-02-10,London,2000000,12667,12667,25334,-1974666,-0.987333,2006,2
68,2006-10-20,Flicka,15000000,21000147,21896367,42896514,27896514,1.8597676,2006,10
68,2007-01-05,Freedom Writers,21000000,36605602,43632609,80238211,59238211,2.8208671904761906,2007,1
68,2007-10-19,Wristcutters: A Love Story,1000000,446165,473769,919934,-80066,-0.080066,2007,10
68,2008-03-07,The Bank Job,20000000,30060660,66143005,96203665,76203665,3.81018325,2008,3
68,2008-03-21,Drillbit Taylor,40000000,32862104,49686263,82548367,42548367,1.063709175,2008,3
68,2008-04-25,Standard Operating Procedure,5000000,228830,332120,560950,-4439050,-0.88781,2008,4
68,2008-07-18,Mamma Mia!,52000000,144130063,615748772,759878835,707878835,13.613054519230769,2008,7
68,2008-12-12,"Che, Part 1: The Argentine",58000000,1802521,31627370,33429891,-24570109,-0.42362256896551725,2008,12
68,2009-06-19,DÃ¸d snÃ¸,800000,46742,2194020,2240762,1440762,1.8009525,2009,6
68,2010-01-15,The Spy Next Door,28000000,24307106,46752858,71059964,43059964,1.537855857142857,2010,1
68,2010-10-08,My Soul to Take,25000000,14744435,16727470,31471905,6471905,0.2588762,2010,10
68,2010-12-10,The Fighter,11000000,93617009,129262388,222879397,211879397,19.261763363636362,2010,12
68,2011-07-22,Elle s'appelait Sarah,14500000,7691700,25480031,33171731,18671731,1.2877055862068965,2011,7
68,2012-04-27,Sound of My Voice,135000,408015,429448,837463,702463,5.20342962962963,2012,4
68,2012-07-11,Snabba Cash,4300000,188870,10212403,10401273,6101273,1.4189006976744185,2012,7
68,2012-08-17,Compliance,270000,319285,830700,1149985,879985,3.2592037037037036,2012,8
68,2012-12-21,Jack Reacher,60000000,80070736,217370736,297441472,237441472,3.9573578666666664,2012,12
68,2013-03-29,The Host,50000000,26623701,64477051,91100752,41100752,0.82201504,2013,3
68,2013-05-16,Star Trek Into Darkness,190000000,228778661,467381584,696160245,506160245,2.6640012894736844,2013,5
68,2014-08-08,Teenage Mutant Ninja Turtles,125000000,191204754,485004754,676209508,551209508,4.409676064,2014,8
68,2014-09-05,Thunder and the House of Magic,34000000,4091,62582520,62586611,28586611,0.8407826764705882,2014,9
68,2014-10-17,Fury,80000000,85817906,210315681,296133587,216133587,2.7016698375,2014,10
68,2014-12-31,A Most Violent Year,20000000,5749134,8846875,14596009,-5403991,-0.27019955,2014,12
68,2015-07-24,Paper Towns,12000000,32000304,85450484,117450788,105450788,8.787565666666667,2015,7
68,2015-07-31,Mission: ImpossibleâRogue Nation,150000000,195042377,688858992,883901369,733901369,4.892675793333333,2015,7
68,2016-01-22,The Boy,10000000,35819556,68220952,104040508,94040508,9.4040508,2016,1
68,2016-06-24,The Neon Demon,7500000,1333124,3559803,4892927,-2607073,-0.34760973333333334,2016,6
68,2016-10-07,The Girl on the Train,45000000,75395035,174278214,249673249,204673249,4.548294422222222,2016,10
68,2016-10-14,Max Steel,10000000,3818664,4563080,8381744,-1618256,-0.1618256,2016,10
69,1939-10-17,Mr. Smith Goes To Washington,1500000,9000000,9000000,18000000,16500000,11.0,1939,10
69,1940-11-13,Fantasia,2280000,83320000,83320000,166640000,164360000,72.08771929824562,1940,11
69,1942-11-16,Cat People,134000,4000000,8000000,12000000,11866000,88.55223880597015,1942,11
69,1956-12-23,The Wrong Man,1200000,2000000,2000000,4000000,2800000,2.3333333333333335,1956,12
69,1966-12-12,A Man for All Seasons,3900000,28350000,28350000,56700000,52800000,13.538461538461538,1966,12
69,1981-05-01,Graduation Day,250000,23894000,23894000,47788000,47538000,190.152,1981,5
69,1981-12-04,Reds,33500000,50000000,50000000,100000000,66500000,1.9850746268656716,1981,12
69,1985-10-04,Commando,10000000,35073978,35073978,70147956,60147956,6.0147956,1985,10
69,1990-10-19,Night of the Living Dead,4200000,5835247,5835247,11670494,7470494,1.7786890476190476,1990,10
69,1993-12-15,Schindlerâs List,25000000,96898818,322197132,419095950,394095950,15.763838,1993,12
69,1996-07-10,Harriet the Spy,13000000,26570048,26570048,53140096,40140096,3.0876996923076923,1996,7
69,1998-03-20,Wild Things,20000000,29795299,55576699,85371998,65371998,3.2685999,1998,3
69,1998-06-19,The X Files: Fight the Future,66000000,83898313,189176423,273074736,207074736,3.137496,1998,6
69,1998-11-06,The Waterboy,23000000,161491646,190191646,351683292,328683292,14.290577913043478,1998,11
69,1999-01-15,Virus,75000000,14010690,30626690,44637380,-30362620,-0.4048349333333333,1999,1
69,1999-12-24,Galaxy Quest,45000000,71423726,90523726,161947452,116947452,2.598832266666667,1999,12
69,2000-03-10,Mission to Mars,90000000,60874615,106000000,166874615,76874615,0.8541623888888888,2000,3
69,2000-05-05,Luminarias,1000000,428535,428535,857070,-142930,-0.14293,2000,5
69,2003-03-28,Basic,50000000,26599248,42598498,69197746,19197746,0.38395492,2003,3
69,2003-06-27,28 Days Laterâ¦,8000000,45064915,82955633,128020548,120020548,15.0025685,2003,6
69,2003-07-24,Masked and Anonymous,7500000,533344,555335,1088679,-6411321,-0.8548428,2003,7
69,2003-10-17,The Texas Chainsaw Massacre,9000000,80571655,107967319,188538974,179538974,19.948774888888888,2003,10
69,2003-12-24,Monster,5000000,34469210,64240813,98710023,93710023,18.7420046,2003,12
69,2004-04-09,The Girl Next Door,25000000,14589444,31635150,46224594,21224594,0.84898376,2004,4
69,2004-04-23,Man on Fire,60000000,77906816,130968579,208875395,148875395,2.4812565833333333,2004,4
69,2004-04-30,Mean Girls,18000000,86047227,130953026,217000253,199000253,11.05556961111111,2004,4
69,2004-04-30,Godsend,30000000,14334645,16910708,31245353,1245353,0.041511766666666665,2004,4
69,2004-05-28,On the Downlow,10000,1987,1987,3974,-6026,-0.6026,2004,5
69,2006-06-02,The Break-Up,52000000,118703275,205727307,324430582,272430582,5.239049653846154,2006,6
69,2007-03-23,The Hills Have Eyes II,15000000,20804166,37466538,58270704,43270704,2.8847136,2007,3
69,2007-10-19,Things We Lost in the Fire,16000000,3287315,8120148,11407463,-4592537,-0.2870335625,2007,10
69,2008-05-30,Sex and the City,57500000,152647258,415247258,567894516,510394516,8.876426365217391,2008,5
69,2008-10-10,Quarantine,12000000,31691811,41924774,73616585,61616585,5.134715416666666,2008,10
69,2008-10-17,Max Payne,35000000,40689393,87775050,128464443,93464443,2.6704126571428572,2008,10
69,2008-10-24,High School Musical 3: Senior Year,11000000,90559416,274392880,364952296,353952296,32.17748145454546,2008,10
69,2009-02-06,Polytechnique,6000000,1418304,1418304,2836608,-3163392,-0.527232,2009,2
69,2010-08-27,Circle,2000000,10024,10024,20048,-1979952,-0.989976,2010,8
69,2011-09-30,Tucker & Dale vs. Evil,5000000,223838,5476793,5700631,700631,0.1401262,2011,9
69,2011-11-23,A Dangerous Method,20000000,5702083,14807531,20509614,509614,0.0254807,2011,11
69,2011-12-16,Sherlock Holmes: A Game of Shadows,125000000,186848418,535663443,722511861,597511861,4.780094888,2011,12
69,2012-09-28,Looper,30000000,66486205,170466405,236952610,206952610,6.898420333333333,2012,9
69,2012-10-12,Sinister,3000000,48086903,87727807,135814710,132814710,44.27157,2012,10
69,2012-12-25,Django Unchained,100000000,162805434,449948323,612753757,512753757,5.12753757,2012,12
69,2013-06-21,World War Z,190000000,202359711,531514650,733874361,543874361,2.8624966368421054,2013,6
69,2014-04-25,Brick Mansions,28000000,20396829,73421224,93818053,65818053,2.35064475,2014,4
69,2014-08-13,Letâs Be Cops,17000000,82390774,136890774,219281548,202281548,11.898914588235295,2014,8
69,2014-09-19,Not Cool,800000,35688,35688,71376,-728624,-0.91078,2014,9
69,2016-01-22,The 5th Wave,38000000,34912982,111336398,146249380,108249380,2.8486678947368422,2016,1
69,2016-03-30,Everybody Wants Some,10000000,3400278,5437126,8837404,-1162596,-0.1162596,2016,3
69,2016-12-21,Patriots Day,40000000,31886361,52837989,84724350,44724350,1.11810875,2016,12
69,2017-07-21,Dunkirk,150000000,190068280,499837368,689905648,539905648,3.5993709866666665,2017,7
69,2017-08-04,Kidnap,21000000,30718107,34836080,65554187,44554187,2.1216279523809525,2017,8
69,2018-09-28,Smallfoot,80000000,83240103,213691277,296931380,216931380,2.71164225,2018,9
70,1925-12-30,Ben-Hur: A Tale of the Christ,3900000,9000000,9000000,18000000,14100000,3.6153846153846154,1925,12
70,1971-01-01,Fiddler on the Roof,9000000,80500000,80500000,161000000,152000000,16.88888888888889,1971,1
70,1975-09-26,The Rocky Horror Picture Show,1200000,1414845,1615976,3030821,1830821,1.5256841666666667,1975,9
70,1979-06-22,Escape from Alcatraz,8000000,43000000,43000000,86000000,78000000,9.75,1979,6
70,1982-08-13,Friday the 13th Part 3,2250000,36690067,36690067,73380134,71130134,31.61339288888889,1982,8
70,1984-06-01,Star Trek III: The Search for Spock,18000000,76471046,87000000,163471046,145471046,8.081724777777778,1984,6
70,1991-06-28,The Naked Gun 2Â½: The Smell of Fear,23000000,86930411,86930411,173860822,150860822,6.559166173913043,1991,6
70,1991-12-27,Fried Green Tomatoes,11000000,81204830,81204830,162409660,151409660,13.764514545454546,1991,12
70,1992-08-07,Unforgiven,14400000,101157447,159157447,260314894,245914894,17.077423194444446,1992,8
70,1992-12-11,A Few Good Men,33000000,141340178,236500000,377840178,344840178,10.449702363636364,1992,12
70,1996-04-01,Bang,10000,527,527,1054,-8946,-0.8946,1996,4
70,1996-10-04,Crash,10000000,3357324,3357324,6714648,-3285352,-0.3285352,1996,10
70,1997-04-04,Chasing Amy,250000,12006514,15155095,27161609,26911609,107.646436,1997,4
70,1997-10-17,I Know What You Did Last Summer,17000000,72250091,125250091,197500182,180500182,10.617657764705882,1997,10
70,1998-03-27,No Looking Back,5000000,143273,143273,286546,-4713454,-0.9426908,1998,3
70,2000-08-18,The Original Kings of Comedy,3000000,38168022,38236338,76404360,73404360,24.46812,2000,8
70,2000-12-22,The Family Man,60000000,75764085,124715863,200479948,140479948,2.3413324666666666,2000,12
70,2001-02-23,Monkeybone,75000000,5409517,5409517,10819034,-64180966,-0.8557462133333333,2001,2
70,2001-07-04,Scary Movie 2,45000000,71277420,141189101,212466521,167466521,3.7214782444444445,2001,7
70,2002-03-15,Resident Evil,35000000,40119709,103787401,143907110,108907110,3.111631714285714,2002,3
70,2002-08-21,One Hour Photo,12000000,31597131,52223306,83820437,71820437,5.9850364166666665,2002,8
70,2002-10-11,The Transporter,21000000,25296447,43928932,69225379,48225379,2.296446619047619,2002,10
70,2002-11-08,8 Mile,41000000,116724075,245768384,362492459,321492459,7.841279487804878,2002,11
70,2003-06-20,Alex & Emma,30000000,14208384,15358583,29566967,-433033,-0.014434433333333333,2003,6
70,2003-07-02,"Legally Blonde 2: Red, White & Blonde",25000000,90639088,125339088,215978176,190978176,7.63912704,2003,7
70,2004-05-28,The Day After Tomorrow,125000000,186740799,556319450,743060249,618060249,4.944481992,2004,5
70,2006-02-10,The Pink Panther,80000000,82226474,158926474,241152948,161152948,2.01441185,2006,2
70,2006-02-17,Nochnoy dozor,4200000,1502188,33913542,35415730,31215730,7.432316666666667,2006,2
70,2006-05-12,Just My Luck,28000000,17326650,38159905,55486555,27486555,0.9816626785714285,2006,5
70,2006-07-07,A Scanner Darkly,20000000,5501616,7405084,12906700,-7093300,-0.354665,2006,7
70,2008-08-15,Fly Me To the Moon,25000000,14543943,43530281,58074224,33074224,1.32296896,2008,8
70,2008-10-31,Eden Lake,2000000,7321,4294373,4301694,2301694,1.150847,2008,10
70,2009-02-06,Push,38000000,31811527,49678401,81489928,43489928,1.1444717894736842,2009,2
70,2009-10-16,The Stepfather,20000000,29062561,29227561,58290122,38290122,1.9145061,2009,10
70,2010-02-12,Valentine's Day,52000000,110485654,217569328,328054982,276054982,5.308749653846154,2010,2
70,2010-09-10,Resident Evil: Afterlife,57500000,60128566,295874190,356002756,298502756,5.19135227826087,2010,9
70,2010-12-22,Little Fockers,100000000,148438600,310650574,459089174,359089174,3.59089174,2010,12
70,2011-05-06,Thor,150000000,181030624,449326618,630357242,480357242,3.2023816133333334,2011,5
70,2011-07-15,Snow Flower and the Secret Fan,6000000,1348205,11348205,12696410,6696410,1.1160683333333334,2011,7
70,2011-12-25,Extremely Loud and Incredibly Close,40000000,31847881,55247881,87095762,47095762,1.17739405,2011,12
70,2012-02-03,Kill List,800000,29063,462206,491269,-308731,-0.38591375,2012,2
70,2013-02-01,Warm Bodies,30000000,66380662,115121608,181502270,151502270,5.050075666666666,2013,2
70,2013-03-01,21 and Over,13000000,25682380,42195766,67878146,54878146,4.221395846153846,2013,3
70,2013-05-10,The Great Gatsby,190000000,144840419,351040419,495880838,305880838,1.609899147368421,2013,5
70,2014-01-03,Paranormal Activity: The Marked Ones,5000000,32462372,90904854,123367226,118367226,23.6734452,2014,1
70,2014-03-14,Need for Speed,66000000,43568507,194169619,237738126,171738126,2.602092818181818,2014,3
70,2014-07-18,I Origins,1000000,336472,852399,1188871,188871,0.188871,2014,7
70,2014-11-14,The Homesman,16000000,2429989,8217571,10647560,-5352440,-0.3345275,2014,11
70,2015-03-13,Run All Night,50000000,26461644,66961644,93423288,43423288,0.86846576,2015,3
70,2016-04-29,Keanu,15000000,20591853,20688141,41279994,26279994,1.7519996,2016,4
70,2017-05-19,"Everything, Everything",10000000,34121140,61603136,95724276,85724276,8.5724276,2017,5
70,2018-03-16,Tomb Raider,90000000,58250803,273477501,331728304,241728304,2.6858700444444445,2018,3
70,2018-03-23,Unsane,1500000,7690044,14244931,21934975,20434975,13.623316666666666,2018,3
70,2018-04-13,Borg vs McEnroe,7500000,231346,3257922,3489268,-4010732,-0.5347642666666667,2018,4
71,1954-12-23,"20,000 Leagues Under the Sea",5000000,28200000,28200000,56400000,51400000,10.28,1954,12
71,1957-12-18,The Bridge on the River Kwai,3000000,33300000,33300000,66600000,63600000,21.2,1957,12
71,1964-10-22,My Fair Lady,17000000,72000000,72071636,144071636,127071636,7.474802117647059,1964,10
71,1971-10-09,The French Connection,2200000,41158757,41158757,82317514,80117514,36.41705181818182,1971,10
71,1976-01-01,The Blue Bird,1200000,887000,887000,1774000,574000,0.47833333333333333,1976,1
71,1976-01-01,Network,3800000,23689877,23689877,47379754,43579754,11.468356315789475,1976,1
71,1994-07-01,The Shadow,40000000,31835600,31835600,63671200,23671200,0.59178,1994,7
71,1994-07-15,True Lies,100000000,146282411,365300000,511582411,411582411,4.11582411,1994,7
71,1995-07-21,Kids,1500000,7412216,20412216,27824432,26324432,17.549621333333334,1995,7
71,1995-11-22,Casino,52000000,42438300,110400000,152838300,100838300,1.939198076923077,1995,11
71,1996-09-13,Maximum Risk,25000000,14102929,51702929,65805858,40805858,1.63223432,1996,9
71,1998-07-24,Saving Private Ryan,65000000,216335085,485035085,701370170,636370170,9.790310307692307,1998,7
71,1998-08-21,Blade,45000000,70141876,131237688,201379564,156379564,3.475101422222222,1998,8
71,1999-12-17,Bicentennial Man,90000000,58220776,87420776,145641552,55641552,0.6182394666666666,1999,12
71,2000-03-31,High Fidelity,20000000,27277055,47881663,75158718,55158718,2.7579359,2000,3
71,2000-06-02,Big Momma's House,33000000,117559438,173559438,291118876,258118876,7.821784121212121,2000,6
71,2000-10-13,Lost Souls,28000000,16779636,31320293,48099929,20099929,0.7178546071428571,2000,10
71,2002-06-28,Lovely and Amazing,250000,4210379,4613482,8823861,8573861,34.295444,2002,6
71,2002-08-09,Blood Work,50000000,26199517,26199517,52399034,2399034,0.04798068,2002,8
71,2002-09-13,Betty Fisher et autres histoires,7500000,206400,206400,412800,-7087200,-0.94496,2002,9
71,2002-12-13,About Schmidt,30000000,65005217,107054484,172059701,142059701,4.735323366666667,2002,12
71,2004-01-30,You Got Served,8000000,40066497,50811858,90878355,82878355,10.359794375,2004,1
71,2004-03-26,Scooby-Doo 2: Monsters Unleashed,25000000,84185387,181185387,265370774,240370774,9.61483096,2004,3
71,2004-03-26,The Ladykillers,35000000,39692139,77392139,117084278,82084278,2.345265085714286,2004,3
71,2004-09-03,Wicker Park,30000000,13001257,21577076,34578333,4578333,0.1526111,2004,9
71,2005-09-09,The Exorcism of Emily Rose,18000000,75072454,144529078,219601532,201601532,11.200085111111111,2005,9
71,2006-01-27,Manderlay,14200000,74205,543306,617511,-13582489,-0.956513309859155,2006,1
71,2006-09-22,Jackass: Number Two,11000000,72778712,85278712,158057424,147057424,13.368856727272727,2006,9
71,2007-11-21,The Mist,13000000,25593755,57189408,82783163,69783163,5.367935615384615,2007,11
71,2008-02-01,The Eye,12000000,31418697,57577765,88996462,76996462,6.416371833333334,2008,2
71,2008-03-14,Never Back Down,21000000,24850922,39319801,64170723,43170723,2.0557487142857145,2008,3
71,2008-08-14,The Rise and Fall of Miss Thang,10000,401,401,802,-9198,-0.9198,2008,8
71,2008-11-07,Madagascar: Escape 2 Africa,150000000,180174880,599680774,779855654,629855654,4.1990376933333335,2008,11
71,2009-08-14,Bandslam,20000000,5210988,12967829,18178817,-1821183,-0.09105915,2009,8
71,2009-11-06,Disneyâs A Christmas Carol,190000000,137855863,315709697,453565560,263565560,1.3871871578947368,2009,11
71,2010-06-11,Jerusalema,2000000,7294,10679,17973,-1982027,-0.9910135,2010,6
71,2010-08-13,Animal Kingdom,4200000,1044039,8078683,9122722,4922722,1.1720766666666667,2010,8
71,2010-09-17,Devil,10000000,33679655,63354114,97033769,87033769,8.7033769,2010,9
71,2010-12-22,Country Strong,15000000,20218921,20601987,40820908,25820908,1.7213938666666666,2010,12
71,2011-07-08,Zookeeper,80000000,80360866,170805525,251166391,171166391,2.1395798875,2011,7
71,2011-09-09,Contagion,60000000,75658097,137551594,213209691,153209691,2.55349485,2011,9
71,2012-06-15,That's My Boy,57500000,36931089,58085235,95016324,37516324,0.6524578086956522,2012,6
71,2012-10-12,Atlas Shrugged: Part II,10000000,3336053,3336053,6672106,-3327894,-0.3327894,2012,10
71,2013-04-05,Trance,16000000,2322593,22594052,24916645,8916645,0.5572903125,2013,4
71,2013-09-20,Rush,38000000,26947624,98230839,125178463,87178463,2.2941700789473685,2013,9
71,2014-07-18,The Purge: Anarchy,9000000,71562550,111534881,183097431,174097431,19.344159,2014,7
71,2014-11-28,Antarctica: A Year on Ice,1000000,288757,288757,577514,-422486,-0.422486,2014,11
71,2015-08-07,Cop Car,5000000,134552,143658,278210,-4721790,-0.944358,2015,8
71,2017-03-31,The Boss Baby,125000000,175003033,510878762,685881795,560881795,4.48705436,2017,3
71,2018-09-14,Mandy,6000000,1214525,1427656,2642181,-3357819,-0.5596365,2018,9
71,2018-11-16,Green Book,23000000,85080171,322034439,407114610,384114610,16.700635217391305,2018,11
71,2019-05-31,Rocketman,41000000,57342725,108642725,165985450,124985450,3.0484256097560976,2019,5
72,1965-12-29,Thunderball,9000000,63600000,141200000,204800000,195800000,21.755555555555556,1965,12
72,1978-01-01,Coming Home,3000000,32653000,32653000,65306000,62306000,20.768666666666668,1978,1
72,1985-03-22,Friday the 13th Part V: A New Beginning,2200000,21930418,21930418,43860836,41660836,18.936743636363637,1985,3
72,1985-06-28,Pale Rider,6900000,41410568,41410568,82821136,75921136,11.003063188405797,1985,6
72,1990-03-23,Pretty Woman,14000000,178406268,432645872,611052140,597052140,42.64658142857143,1990,3
72,1992-03-13,My Cousin Vinny,11000000,52929168,52929168,105858336,94858336,8.62348509090909,1992,3
72,1994-02-04,Romeo Is Bleeding,10000000,3275585,3275585,6551170,-3448830,-0.344883,1994,2
72,1995-04-07,Bad Boys,23000000,65647413,141247413,206894826,183894826,7.995427217391304,1995,4
72,1997-10-17,Devil's Advocate,57000000,61007424,153007424,214014848,157014848,2.754646456140351,1997,10
72,1999-12-10,Deuce Bigalow: Male Gigolo,18000000,65535067,92935067,158470134,140470134,7.803896333333333,1999,12
72,1999-12-22,Any Given Sunday,60000000,75530832,100230832,175761664,115761664,1.9293610666666667,1999,12
72,2000-12-15,What Women Want,65000000,182805123,374105123,556910246,491910246,7.5678499384615385,2000,12
72,2001-03-16,Exit Wounds,33000000,51758599,79958599,131717198,98717198,2.9914302424242423,2001,3
72,2001-05-11,A Knightâs Tale,41000000,56083966,100622586,156706552,115706552,2.822111024390244,2001,5
72,2001-05-18,Angel Eyes,38000000,24044532,29544532,53589064,15589064,0.4102385263157895,2001,5
72,2001-12-07,The Business of Strangers,6000000,1030920,1290920,2321840,-3678160,-0.6130266666666667,2001,12
72,2002-09-13,Stealing Harvard,25000000,13973532,13973532,27947064,2947064,0.11788256,2002,9
72,2002-10-11,Tuck Everlasting,15000000,19161999,19344615,38506614,23506614,1.5671076,2002,10
72,2002-11-22,Friday After Next,10000000,33253609,33526835,66780444,56780444,5.6780444,2002,11
72,2003-08-22,The Battle of Shaker Heights,1000000,280351,839145,1119496,119496,0.119496,2003,8
72,2004-04-07,Johnson Family Vacation,12000000,31203964,31286759,62490723,50490723,4.20756025,2004,4
72,2004-07-07,King Arthur,90000000,51877963,203877963,255755926,165755926,1.8417325111111111,2004,7
72,2004-07-09,Anchorman: The Legend of Ron Burgundy,25000000,84136909,89476265,173613174,148613174,5.94452696,2004,7
72,2004-08-06,Saints and Soldiers,780000,1310470,1310470,2620940,1840940,2.360179487179487,2004,8
72,2004-08-06,Code 46,7500000,197148,1788324,1985472,-5514528,-0.7352704,2004,8
72,2004-10-22,Sideways,17000000,71502303,109793192,181295495,164295495,9.664440882352942,2004,10
72,2005-01-14,Coach Carter,45000000,67264877,76665507,143930384,98930384,2.198452977777778,2005,1
72,2005-01-28,Alone in the Dark,20000000,5178569,10588079,15766648,-4233352,-0.2116676,2005,1
72,2005-10-05,The Squid and the Whale,1500000,7372734,11191423,18564157,17064157,11.376104666666667,2005,10
72,2005-12-25,The New World,30000000,12712093,26184400,38896493,8896493,0.29654976666666666,2005,12
72,2006-04-28,Stick It,20000000,26910736,30399714,57310450,37310450,1.8655225,2006,4
72,2006-06-23,Say Uncle,2000000,5361,5361,10722,-1989278,-0.994639,2006,6
72,2007-11-02,American Gangster,100000000,130164645,267985456,398150101,298150101,2.98150101,2007,11
72,2008-11-26,Transporter 3,40000000,31715062,107235592,138950654,98950654,2.47376635,2008,11
72,2008-12-12,The Day the Earth Stood Still,80000000,79366978,237370350,316737328,236737328,2.9592166,2008,12
72,2009-02-13,The International,50000000,25450527,53850527,79301054,29301054,0.58602108,2009,2
72,2009-05-01,X-Men Origins: Wolverine,150000000,179883157,374825760,554708917,404708917,2.6980594466666665,2009,5
72,2010-04-01,Clash of the Titans,125000000,163214888,493214888,656429776,531429776,4.251438208,2010,4
72,2010-05-28,George A. Romero's Survival of the Dead,4200000,101740,101740,203480,-3996520,-0.9515523809523809,2010,5
72,2010-09-10,"Lovely, Still",5000000,127564,282687,410251,-4589749,-0.9179498,2010,9
72,2011-01-14,Down for Life,3800000,41914,41914,83828,-3716172,-0.97794,2011,1
72,2011-05-06,Something Borrowed,35000000,39046489,65084116,104130605,69130605,1.9751601428571428,2011,5
72,2011-08-05,The Change-Up,52000000,37243418,75997067,113240485,61240485,1.1777016346153846,2011,8
72,2011-12-09,Tinker Tailor Soldier Spy,21000000,24149393,81452811,105602204,84602204,4.028676380952381,2011,12
72,2012-04-13,Blue Like Jazz,1200000,595018,595018,1190036,-9964,-0.008303333333333333,2012,4
72,2013-07-12,Pacific Rim,190000000,101802906,411002906,512805812,322805812,1.6989779578947368,2013,7
72,2014-01-17,The Nut Job,30000000,64251538,122529966,186781504,156781504,5.226050133333334,2014,1
72,2014-04-11,Oculus,5000000,27695246,44115496,71810742,66810742,13.3621484,2014,4
72,2014-05-16,The Immigrant,16000000,2013456,7585011,9598467,-6401533,-0.4000958125,2014,5
72,2015-04-10,Ex Machina,13000000,25440971,38358392,63799363,50799363,3.907643307692308,2015,4
72,2015-08-21,American Ultra,28000000,14439985,30295028,44735013,16735013,0.5976790357142857,2015,8
72,2017-04-28,Sleight,250000,3930990,3934450,7865440,7615440,30.46176,2017,4
72,2019-05-03,The Intruder,8000000,35095904,36005871,71101775,63101775,7.887721875,2019,5
73,1973-08-11,American Graffiti,777000,115000000,140000000,255000000,254223000,327.18532818532816,1973,8
73,1987-09-18,Fatal Attraction,14000000,156645693,320100000,476745693,462745693,33.053263785714286,1987,9
73,1996-08-09,Escape from L.A.,50000000,25426861,25426861,50853722,853722,0.01707444,1996,8
73,1997-04-25,Volcano,90000000,47546796,120100000,167646796,77646796,0.8627421777777777,1997,4
73,1997-08-08,Conspiracy Theory,80000000,76118990,142783718,218902708,138902708,1.73628385,1997,8
73,1997-08-15,Steel,16000000,1686429,1686429,3372858,-12627142,-0.789196375,1997,8
73,1998-05-15,The Horse Whisperer,60000000,75383563,186883563,262267126,202267126,3.3711187666666667,1998,5
73,1998-11-20,Waking Ned Devine,3000000,24793251,55193251,79986502,76986502,25.662167333333333,1998,11
73,1998-12-23,The Thin Red Line,52000000,36400491,97709034,134109525,82109525,1.5790293269230768,1998,12
73,1999-10-08,The Limey,10000000,3193102,6030047,9223149,-776851,-0.0776851,1999,10
73,1999-10-29,Being John Malkovich,13000000,22858926,32382381,55241307,42241307,3.249331307692308,1999,10
73,2001-02-16,Down to Earth,30000000,64172251,71172251,135344502,105344502,3.5114834,2001,2
73,2001-12-21,How High,12000000,31155435,31222395,62377830,50377830,4.1981525,2001,12
73,2001-12-21,Joe Somebody,38000000,22770864,24515990,47286854,9286854,0.2443908947368421,2001,12
73,2002-03-13,Kissing Jessica Stein,1500000,7025722,9345061,16370783,14870783,9.913855333333334,2002,3
73,2003-04-11,Better Luck Tomorrow,250000,3802390,3809226,7611616,7361616,29.446464,2003,4
73,2003-04-18,Winged Migration,28000000,11689053,39134983,50824036,22824036,0.8151441428571429,2003,4
73,2003-06-13,Tycoon,5000000,121016,121016,242032,-4757968,-0.9515936,2003,6
73,2003-08-15,Freddy vs. Jason,25000000,82622655,114576403,197199058,172199058,6.88796232,2003,8
73,2003-08-22,The Medallion,41000000,22108977,22108977,44217954,3217954,0.07848668292682927,2003,8
73,2004-01-01,Barbershop 2: Back in Business,18000000,65070412,65842412,130912824,112912824,6.272934666666667,2004,1
73,2004-10-29,Birth,20000000,5005899,14603001,19608900,-391100,-0.019555,2004,10
73,2006-10-13,The Marine,15000000,18844784,22165608,41010392,26010392,1.7340261333333333,2006,10
73,2006-12-01,The Nativity Story,35000000,37629831,46309644,83939475,48939475,1.3982707142857143,2006,12
73,2007-02-09,The Last Sin Eater,2200000,388390,388390,776780,-1423220,-0.6469181818181818,2007,2
73,2007-06-29,Evening,30000000,12406646,12885574,25292220,-4707780,-0.156926,2007,6
73,2007-08-03,Hot Rod,25000000,13938332,14334401,28272733,3272733,0.13090932,2007,8
73,2008-01-04,One Missed Call,20000000,26890041,44513466,71403507,51403507,2.57017535,2008,1
73,2008-01-18,Taxi to the Dark Side,1000000,274661,304472,579133,-420867,-0.420867,2008,1
73,2008-05-30,The Strangers,9000000,52597610,83051676,135649286,126649286,14.072142888888889,2008,5
73,2009-05-22,Night at the Museum: Battle of the Smithsonian,150000000,177243721,402231063,579474784,429474784,2.8631652266666667,2009,5
73,2009-09-18,Cloudy with a Chance of Meatballs,100000000,124870275,236827677,361697952,261697952,2.61697952,2009,9
73,2010-03-19,The Bounty Hunter,45000000,67061228,135808837,202870065,157870065,3.508223666666667,2010,3
73,2010-04-30,The Good Heart,3800000,20930,340930,361860,-3438140,-0.9047736842105263,2010,4
73,2010-11-10,Morning Glory,40000000,31011732,59795070,90806802,50806802,1.27017005,2010,11
73,2011-04-29,JÃ»san-nin no shikaku,6000000,802778,18727440,19530218,13530218,2.2550363333333334,2011,4
73,2011-09-30,50/50,8000000,35016118,41334735,76350853,68350853,8.543856625,2011,9
73,2012-01-13,Newlyweds,9000,4584,4584,9168,168,0.018666666666666668,2012,1
73,2012-02-17,Ghost Rider: Spirit of Vengeance,57000000,51774002,149217355,200991357,143991357,2.526164157894737,2012,2
73,2012-06-15,Your Sister's Sister,120000,1597486,3090593,4688079,4568079,38.067325,2012,6
73,2012-09-21,House at the End of the Street,6900000,31611916,44103982,75715898,68815898,9.973318550724638,2012,9
73,2012-11-09,Lincoln,65000000,182207973,273346281,455554254,390554254,6.008526984615385,2012,11
73,2013-09-13,Plush,2000000,3080,28864,31944,-1968056,-0.984028,2013,9
73,2013-11-01,Dallas Buyers Club,5000000,27298285,60611845,87910130,82910130,16.582026,2013,11
73,2013-11-15,The Best Man Holiday,17000000,70525195,72835710,143360905,126360905,7.432994411764706,2013,11
73,2014-08-22,If I Stay,11000000,50474843,78356170,128831013,117831013,10.711910272727273,2014,8
73,2015-01-16,The Wedding Ringer,23000000,64460211,80171596,144631807,121631807,5.288339434782609,2015,1
73,2015-03-06,The Second Best Exotic Marigold Hotel,10000000,33078266,90384306,123462572,113462572,11.3462572,2015,3
73,2015-07-10,Minions,74000000,336045770,1160336173,1496381943,1422381943,19.221377608108106,2015,7
73,2015-08-28,Que Horas Ela Volta?,1200000,376976,3249041,3626017,2426017,2.0216808333333334,2015,8
73,2015-11-25,The Good Dinosaur,187500000,123087120,333771037,456858157,269358157,1.4365768373333334,2015,11
73,2016-07-08,Mike and Dave Need Wedding Dates,33000000,46009673,75898100,121907773,88907773,2.6941749393939394,2016,7
73,2016-11-04,Trolls,125000000,153707064,344150134,497857198,372857198,2.982857584,2016,11
73,2017-09-22,Victoria and Abdul,21000000,22245070,68271146,90516216,69516216,3.310296,2017,9
74,1945-10-31,Spellbound,1500000,7000000,7000000,14000000,12500000,8.333333333333334,1945,10
74,1960-10-07,Spartacus,12000000,30000000,60000000,90000000,78000000,6.5,1960,10
74,1965-04-07,Major Dundee,3800000,14873,14873,29746,-3770254,-0.9921721052631579,1965,4
74,1982-11-19,Q,1200000,255000,255000,510000,-690000,-0.575,1982,11
74,1985-03-22,The Last Dragon,10000000,33000000,33000000,66000000,56000000,5.6,1985,3
74,1989-04-07,Major League,11000000,49793054,49793054,99586108,88586108,8.053282545454545,1989,4
74,1991-08-30,Beastmaster 2: Through the Portal of Time,6000000,773490,773490,1546980,-4453020,-0.74217,1991,8
74,1993-02-26,El Mariachi,7000,2040920,2041928,4082848,4075848,582.264,1993,2
74,1993-09-24,Dazed and Confused,6900000,7950889,7950889,15901778,9001778,1.304605507246377,1993,9
74,1995-08-04,Babe,30000000,63658910,246100000,309758910,279758910,9.325297,1995,8
74,1996-01-12,Eye for an Eye,20000000,26792700,26792700,53585400,33585400,1.67927,1996,1
74,1996-04-03,A Thin Line Between Love & Hate,8000000,34873513,34873513,69747026,61747026,7.71837825,1996,4
74,1996-05-31,Dragonheart,57000000,51364680,104364680,155729360,98729360,1.7320940350877192,1996,5
74,1996-11-06,Set It Off,9000000,36049108,36049108,72098216,63098216,7.010912888888889,1996,11
74,1997-03-26,The Devil's Own,90000000,42885593,140900000,183785593,93785593,1.0420621444444444,1997,3
74,1997-08-01,Air Bud,3000000,24646936,27788649,52435585,49435585,16.478528333333333,1997,8
74,1998-05-19,Godzilla,125000000,136314294,376000000,512314294,387314294,3.098514352,1998,5
74,1998-06-12,"Six Days, Seven Nights",80000000,74339294,164800000,239139294,159139294,1.989241175,1998,6
74,1998-07-24,Disturbing Behavior,15000000,17507368,19014238,36521606,21521606,1.4347737333333332,1998,7
74,1999-06-04,Desert Blue,5000000,99147,99147,198294,-4801706,-0.9603412,1999,6
74,1999-11-05,The Bachelor,21000000,21731001,36882378,58613379,37613379,1.7911132857142857,1999,11
74,1999-12-22,Man on the Moon,52000000,34580635,47407635,81988270,29988270,0.5766975,1999,12
74,2000-03-10,The Ninth Gate,38000000,18653746,58394308,77048054,39048054,1.0275803684210527,2000,3
74,2000-03-17,Final Destination,23000000,53302314,112036870,165339184,142339184,6.188660173913044,2000,3
74,2001-09-07,Two Can Play That Game,13000000,22235901,22391450,44627351,31627351,2.432873153846154,2001,9
74,2002-03-15,Ice Age,65000000,176387405,386116343,562503748,497503748,7.6539038153846155,2002,3
74,2002-04-12,Changing Lanes,45000000,66790248,66790248,133580496,88580496,1.9684554666666667,2002,4
74,2004-02-27,Twisted,50000000,25195050,40119848,65314898,15314898,0.30629796,2004,2
74,2005-11-09,Get Rich or Die Tryin',40000000,30981850,46666955,77648805,37648805,0.941220125,2005,11
74,2005-12-16,The Family Stone,18000000,60062868,92357499,152420367,134420367,7.467798166666666,2005,12
74,2005-12-21,The White Countess,16000000,1669971,2814566,4484537,-11515463,-0.7197164375,2005,12
74,2007-02-16,Bridge to Terabithia,25000000,82234139,137984788,220218927,195218927,7.80875708,2007,2
74,2008-05-02,Iron Man,186000000,318604126,585171547,903775673,717775673,3.859008994623656,2008,5
74,2008-11-12,Slumdog Millionaire,14000000,141330703,384530440,525861143,511861143,36.56151021428571,2008,11
74,2009-02-06,Coraline,60000000,75286229,126037057,201323286,141323286,2.3553881,2009,2
74,2009-02-13,Friday the 13th,17000000,65002019,92670237,157672256,140672256,8.274838588235294,2009,2
74,2010-08-06,The Other Guys,100000000,119219978,170936470,290156448,190156448,1.90156448,2010,8
74,2011-05-26,Kung Fu Panda 2,150000000,165249063,664837547,830086610,680086610,4.533910733333333,2011,5
74,2011-09-09,Warrior,25000000,13657115,24215385,37872500,12872500,0.5149,2011,9
74,2011-10-14,The Big Year,41000000,7204138,7684524,14888662,-26111338,-0.6368619024390244,2011,10
74,2011-10-28,Like Crazy,250000,3395391,3728400,7123791,6873791,27.495164,2011,10
74,2011-10-28,In Time,35000000,37553932,165103952,202657884,167657884,4.790225257142857,2011,10
74,2012-07-27,Step Up Revolution,33000000,35074677,165552290,200626967,167626967,5.0796050606060605,2012,7
74,2012-10-26,The Ghastly Love of Johnny X,2000000,2436,2436,4872,-1995128,-0.997564,2012,10
74,2013-01-18,The Last Stand,30000000,12050299,48330757,60381056,30381056,1.0127018666666667,2013,1
74,2014-11-14,Rosewater,10000000,3128941,3185717,6314658,-3685342,-0.3685342,2014,11
74,2015-02-06,The SpongeBob Movie: Sponge Out of Water,74000000,162994032,311013181,474007213,400007213,5.405502878378378,2015,2
74,2015-08-26,No Escape,5000000,27288872,42844516,70133388,65133388,13.0266776,2015,8
74,2016-02-05,Pride and Prejudice and Zombies,28000000,10907291,16638300,27545591,-454409,-0.01622889285714286,2016,2
74,2016-04-08,The Invitation,1000000,231738,354836,586574,-413426,-0.413426,2016,4
74,2016-08-26,Hands of Stone,20000000,4712792,5031975,9744767,-10255233,-0.51276165,2016,8
75,1945-05-03,The Valley of Decision,2160000,9132000,9132000,18264000,16104000,7.455555555555556,1945,5
75,1946-01-18,The Harvey Girls,2931000,4100000,4100000,8200000,5269000,1.7976799727055612,1946,1
75,1969-06-18,The Wild Bunch,6000000,509424,509424,1018848,-4981152,-0.830192,1969,6
75,1974-12-17,Towering Inferno,14000000,116000000,139700000,255700000,241700000,17.264285714285716,1974,12
75,1976-12-17,King Kong,23000000,52614445,90614445,143228890,120228890,5.227343043478261,1976,12
75,1979-04-20,Dawn of the Dead,1500000,5100000,55000000,60100000,58600000,39.06666666666667,1979,4
75,1980-10-03,The Elephant Man,5000000,26010864,26010864,52021728,47021728,9.4043456,1980,10
75,1995-06-16,The Incredibly True Adventure of Two Girls in Love,250000,2210408,2477155,4687563,4437563,17.750252,1995,6
75,1995-06-30,Apollo 13,65000000,173772767,335802271,509575038,444575038,6.83961596923077,1995,6
75,1997-04-11,Anaconda,45000000,65598907,136998907,202597814,157597814,3.5021736444444445,1997,4
75,1998-03-06,Love and Death on Long Island,4030000,2542264,2542264,5084528,1054528,0.2616694789081886,1998,3
75,1998-03-06,The Big Lebowski,15000000,17498804,46189568,63688372,48688372,3.2458914666666665,1998,3
75,1999-01-15,In Dreams,30000000,12017369,12017369,24034738,-5965262,-0.19884206666666668,1999,1
75,1999-03-12,The Rage: Carrie 2,21000000,17760244,17760244,35520488,14520488,0.6914518095238095,1999,3
75,1999-08-06,The Sixth Sense,40000000,293506292,672806292,966312584,926312584,23.1578146,1999,8
75,1999-10-01,"Mystery, Alaska",28000000,8891623,8891623,17783246,-10216754,-0.36488407142857143,1999,10
75,1999-12-24,Angela's Ashes,25000000,13038660,13038660,26077320,1077320,0.0430928,1999,12
75,2000-11-22,Unbreakable,73243106,94999143,248099143,343098286,269855180,3.6843765200236045,2000,11
75,2000-12-22,The House of Mirth,10000000,3041803,5149131,8190934,-1809066,-0.1809066,2000,12
75,2001-12-21,Jimmy Neutron: Boy Genius,25000000,80936232,102992536,183928768,158928768,6.35715072,2001,12
75,2002-05-24,Spirit: Stallion of the Cimarron,80000000,73215310,106515310,179730620,99730620,1.24663275,2002,5
75,2002-07-19,K-19: The Widowmaker,90000000,35168966,65716126,100885092,10885092,0.12094546666666667,2002,7
75,2002-10-11,Bowling for Columbine,3000000,21576018,58240487,79816505,76816505,25.605501666666665,2002,10
75,2003-03-21,Down & Out with the Dolls,1200000,58936,58936,117872,-1082128,-0.9017733333333333,2003,3
75,2003-04-04,Phone Booth,11000000,46566212,97837138,144403350,133403350,12.127577272727272,2003,4
75,2003-11-26,Bad Santa,18000000,60060328,77147031,137207359,119207359,6.622631055555556,2003,11
75,2004-02-27,Decoys,5000000,84733,96760,181493,-4818507,-0.9637014,2004,2
75,2004-09-24,Guiana 1838,1000000,227241,227241,454482,-545518,-0.545518,2004,9
75,2004-10-01,Ladder 49,60000000,74541707,102332848,176874555,116874555,1.94790925,2004,10
75,2004-10-08,Primer,7000,424760,841926,1266686,1259686,179.95514285714285,2004,10
75,2004-11-12,After the Sunset,57000000,28328132,38329114,66657246,9657246,0.16942536842105263,2004,11
75,2004-12-10,The Life Aquatic with Steve Zissou,50000000,24006726,34806726,58813452,8813452,0.17626904,2004,12
75,2004-12-17,Lemony Snicket's A Series of Unfortunate Events,100000000,118627117,212956024,331583141,231583141,2.31583141,2004,12
75,2006-08-18,Snakes on a Plane,33000000,34020814,62020814,96041628,63041628,1.9103523636363637,2006,8
75,2006-09-01,Crank,12000000,27838408,43924923,71763331,59763331,4.980277583333334,2006,9
75,2008-04-11,Street Kings,20000000,26418667,65457811,91876478,71876478,3.5938239,2008,4
75,2008-07-18,The Dark Knight,185000000,533720947,1001996207,1535717154,1350717154,7.301173805405406,2008,7
75,2008-07-25,Bienvenue chez les Ch'tis,16000000,1477650,247474497,248952147,232952147,14.5595091875,2008,7
75,2008-10-24,Passchendaele,20000000,4452423,4453327,8905750,-11094250,-0.5547125,2008,10
75,2010-02-05,From Paris With Love,52000000,24077427,53139168,77216595,25216595,0.48493451923076925,2010,2
75,2010-04-23,The Back-up Plan,35000000,37490007,75281179,112771186,77771186,2.2220338857142856,2010,4
75,2011-09-09,Kevin Hart: Laugh at My Pain,750000,7706436,7712436,15418872,14668872,19.558496,2011,9
75,2012-06-08,Prometheus,125000000,126477084,402448265,528925349,403925349,3.231402792,2012,6
75,2012-08-08,Hope Springs,30000000,63536011,133085295,196621306,166621306,5.554043533333333,2012,8
75,2012-09-28,Pitch Perfect,17000000,65001093,116044347,181045440,164045440,9.649731764705882,2012,9
75,2015-05-15,Mad Max: Fury Road,150000000,153636354,370098020,523734374,373734374,2.4915624933333334,2015,5
75,2015-09-02,A Walk in the Woods,8000000,29499394,37119358,66618752,58618752,7.327344,2015,9
75,2016-03-11,Eye in the Sky,13000000,18704596,35402802,54107398,41107398,3.1621075384615382,2016,3
75,2016-10-21,Ouija: Origin of Evil,9000000,35144505,81831866,116976371,107976371,11.997374555555556,2016,10
75,2017-04-28,How to Be a Latin Lover,10000000,32149404,62556228,94705632,84705632,8.4705632,2017,4
75,2017-10-20,Only the Brave,38000000,18340051,24555177,42895228,4895228,0.12882178947368422,2017,10
75,2018-10-05,Hevi reissu,3800000,10153,10153,20306,-3779694,-0.9946563157894737,2018,10
75,2019-05-03,Long Shot,40000000,30202860,43711031,73913891,33913891,0.847847275,2019,5
76,1950-02-15,Cinderella,2900000,85000000,263591415,348591415,345691415,119.20393620689656,1950,2
76,1982-03-19,Porky's,4000000,109492484,109492484,218984968,214984968,53.746242,1982,3
76,1985-11-01,A Nightmare on Elm Street Part 2: Freddy's Revenge,3000000,21163999,21163999,42327998,39327998,13.109332666666667,1985,11
76,1987-05-01,Malone,10000000,3000000,3000000,6000000,-4000000,-0.4,1987,5
76,1987-06-12,Predator,18000000,59735548,98267558,158003106,140003106,7.777950333333333,1987,6
76,1988-05-25,Crocodile Dundee 2,14000000,109306210,239606210,348912420,334912420,23.922315714285713,1988,5
76,1992-03-06,The Lawnmower Man,10000000,32100816,32100816,64201632,54201632,5.4201632,1992,3
76,1992-12-11,The Muppet Christmas Carol,12000000,27281507,27492918,54774425,42774425,3.5645354166666667,1992,12
76,1994-09-23,Exotica,1500000,5046118,5046118,10092236,8592236,5.728157333333334,1994,9
76,1996-09-27,Extreme Measures,38000000,17378193,17378193,34756386,-3243614,-0.08535826315789474,1996,9
76,1998-08-05,Halloween: H2O,17000000,55041738,55041738,110083476,93083476,5.475498588235294,1998,8
76,1999-03-12,Wing Commander,30000000,11578022,11578022,23156044,-6843956,-0.22813186666666666,1999,3
76,1999-03-31,The Matrix,65000000,171479930,463517383,634997313,569997313,8.76918943076923,1999,3
76,1999-07-28,Deep Blue Sea,60000000,73648228,165048228,238696456,178696456,2.978274266666667,1999,7
76,1999-08-04,The Iron Giant,50000000,23159305,31333917,54493222,4493222,0.08986444,1999,8
76,1999-10-22,The Best Man,9000000,34102780,34572780,68675560,59675560,6.630617777777778,1999,10
76,2000-07-14,Chuck&Buck,250000,1055671,1157672,2213343,1963343,7.853372,2000,7
76,2000-08-25,The Art of War,40000000,30199105,30199105,60398210,20398210,0.50995525,2000,8
76,2001-06-08,Swordfish,80000000,69772969,147080413,216853382,136853382,1.710667275,2001,6
76,2001-08-17,Captain Corelli's Mandolin,57000000,25528495,62097495,87625990,30625990,0.5372980701754386,2001,8
76,2001-08-24,John Carpenterâs Ghosts of Mars,28000000,8434601,8434601,16869202,-11130798,-0.3975285,2001,8
76,2002-01-25,A Walk to Remember,11000000,41227069,46060861,87287930,76287930,6.935266363636364,2002,1
76,2002-10-11,Brown Sugar,8000000,27362712,28315272,55677984,47677984,5.959748,2002,10
76,2002-12-30,Love Liza,1000000,213137,213137,426274,-573726,-0.573726,2002,12
76,2003-04-16,Bulletproof Monk,52000000,23010607,23010607,46021214,-5978786,-0.11497665384615384,2003,4
76,2004-04-16,The Punisher,33000000,33664370,54533774,88198144,55198144,1.6726710303030303,2004,4
76,2005-07-15,Wedding Crashers,40000000,209218368,283218368,492436736,452436736,11.3109184,2005,7
76,2006-01-20,Underworld: Evolution,45000000,62318875,113417762,175736637,130736637,2.9052586,2006,1
76,2006-05-26,Cavite,7000,70071,71644,141715,134715,19.245,2006,5
76,2006-08-04,Talladega Nights: The Ballad of Ricky Bobby,73000000,148213377,162870525,311083902,238083902,3.2614233150684933,2006,8
76,2007-04-13,Aqua Teen Hunger Force Colon Movie Film for Theaters,750000,5520368,5520368,11040736,10290736,13.720981333333333,2007,4
76,2008-01-18,Cloverfield,25000000,80048433,171302226,251350659,226350659,9.05402636,2008,1
76,2008-04-18,Forgetting Sarah Marshall,30000000,63172463,105173042,168345505,138345505,4.611516833333333,2008,4
76,2008-05-22,Indiana Jones and the Kingdom of the Crystal Skull,185000000,317101119,786635413,1103736532,918736532,4.966143416216216,2008,5
76,2008-05-30,Stuck,5000000,67505,67505,135010,-4864990,-0.972998,2008,5
76,2008-08-01,Swing Vote,21000000,16289867,17589867,33879734,12879734,0.6133206666666666,2008,8
76,2008-10-03,Flash of Genius,20000000,4442377,4504111,8946488,-11053512,-0.5526756,2008,10
76,2010-09-17,Incendies,6800000,6857096,16038343,22895439,16095439,2.366976323529412,2010,9
76,2011-03-25,The 5th Quarter,6000000,408159,408159,816318,-5183682,-0.863947,2011,3
76,2011-08-19,Conan the Barbarian,90000000,21295021,63356133,84651154,-5348846,-0.05943162222222222,2011,8
76,2011-10-07,The Ides of March,23000000,40962534,77735925,118698459,95698459,4.1608025652173914,2011,10
76,2011-11-09,J. Edgar,35000000,37306030,84606030,121912060,86912060,2.4832017142857143,2011,11
76,2012-06-01,"Pink Ribbons, Inc.",1200000,26608,26608,53216,-1146784,-0.9556533333333334,2012,6
76,2012-08-10,The Bourne Legacy,125000000,113203870,280355920,393559790,268559790,2.14847832,2012,8
76,2013-03-22,Admission,13000000,18007317,18733666,36740983,23740983,1.8262294615384616,2013,3
76,2013-08-23,The World's End,20000000,26004851,47508505,73513356,53513356,2.6756678,2013,8
76,2013-12-25,The Wolf of Wall Street,100000000,116900694,389870414,506771108,406771108,4.06771108,2013,12
76,2014-07-25,A Most Wanted Man,15000000,17237855,36068890,53306745,38306745,2.553783,2014,7
76,2014-10-01,"Men, Women and Children",16000000,705908,1685403,2391311,-13608689,-0.8505430625,2014,10
76,2015-02-27,The Lazarus Effect,5000000,25801570,38359310,64160880,59160880,11.832176,2015,2
76,2017-09-22,Battle of the Sexes,25000000,12638526,18445379,31083905,6083905,0.2433562,2017,9
76,2019-05-10,PokÃ©mon: Detective Pikachu,150000000,139507806,411258433,550766239,400766239,2.6717749266666666,2019,5
77,1950-05-17,Annie Get Your Gun,3768785,8000000,8000000,16000000,12231215,3.245400042719338,1950,5
77,1953-02-05,Peter Pan,4000000,87400000,87400000,174800000,170800000,42.7,1953,2
77,1968-10-01,Night of the Living Dead,114000,12087064,30087064,42174128,42060128,368.94849122807017,1968,10
77,1979-02-02,The First Great Train Robbery,6000000,391942,391942,783884,-5216116,-0.8693526666666667,1979,2
77,1986-03-07,A Room with a View,3000000,20966644,20966644,41933288,38933288,12.977762666666667,1986,3
77,1988-11-09,Child's Play,9000000,33244684,44196684,77441368,68441368,7.604596444444445,1988,11
77,1989-12-20,Born on the Fourth of July,14000000,70001698,70001698,140003396,126003396,9.000242571428572,1989,12
77,1992-03-13,Howards End,8000000,26124872,26317943,52442815,44442815,5.555351875,1992,3
77,1995-12-29,Dead Man Walking,11000000,39387284,83088295,122475579,111475579,10.134143545454545,1995,12
77,1996-01-19,From Dusk Till Dawn,20000000,25728961,25732986,51461947,31461947,1.57309735,1996,1
77,1997-06-20,Batman & Robin,125000000,107325195,238317814,345643009,220643009,1.765144072,1997,6
77,1997-07-11,A Simple Wish,28000000,8165213,8165213,16330426,-11669574,-0.4167705,1997,7
77,1998-11-20,Central do Brasil,2900000,5969553,17006158,22975711,20075711,6.9226589655172415,1998,11
77,1999-12-31,Fantasia 2000 (Theatrical Release),80000000,69610858,69618634,139229492,59229492,0.74036865,1999,12
77,2000-02-18,Pitch Black,23000000,39235088,53182088,92417176,69417176,3.0181380869565215,2000,2
77,2000-06-23,"Me, Myself & Irene",51000000,90570999,149270999,239841998,188841998,3.702784274509804,2000,6
77,2000-08-04,Coyote Ugly,45000000,60786269,113916474,174702743,129702743,2.882283177777778,2000,8
77,2000-08-11,AimÃ©e & Jaguar,6800000,927107,927107,1854214,-4945786,-0.7273214705882353,2000,8
77,2000-09-08,The Watcher,33000000,28946615,47267829,76214444,43214444,1.3095286060606062,2000,9
77,2000-11-17,Bounce,35000000,36805288,53425292,90230580,55230580,1.5780165714285714,2000,11
77,2001-01-12,Antitrust,30000000,10965209,17865209,28830418,-1169582,-0.038986066666666666,2001,1
77,2001-03-16,American Desi,250000,902835,1366235,2269070,2019070,8.07628,2001,3
77,2001-03-16,Memento,5000000,25544867,39723096,65267963,60267963,12.0535926,2001,3
77,2003-11-05,The Matrix Revolutions,150000000,139270910,427300260,566571170,416571170,2.777141133333333,2003,11
77,2004-10-08,Friday Night Lights,30000000,61255921,61950770,123206691,93206691,3.1068897,2004,10
77,2004-12-31,The Mongol King,7000,900,900,1800,-5200,-0.7428571428571429,2004,12
77,2006-06-02,Peaceful Warrior,10000000,2893666,3260179,6153845,-3846155,-0.3846155,2006,6
77,2006-07-07,Once in a Lifetime: the Extraordinary Story of the New York Cosmos,1000000,144601,215559,360160,-639840,-0.63984,2006,7
77,2007-11-16,Redacted,5000000,65388,861325,926713,-4073287,-0.8146574,2007,11
77,2007-11-21,Iâm Not There,20000000,4017609,12397613,16415222,-3584778,-0.1792389,2007,11
77,2008-10-03,Nick and Norah's Infinite Playlist,10000000,31487293,33886017,65373310,55373310,5.537331,2008,10
77,2009-06-05,Away We Go,21000000,9451946,10108016,19559962,-1440038,-0.06857323809523809,2009,6
77,2009-06-26,The Hurt Locker,15000000,17017811,49894223,66912034,51912034,3.4608022666666667,2009,6
77,2009-10-28,Michael Jackson's This Is It,60000000,72091016,252091016,324182032,264182032,4.403033866666667,2009,10
77,2010-02-05,Dear John,25000000,80014842,142033509,222048351,197048351,7.88193404,2010,2
77,2010-06-11,The Karate Kid,40000000,176591618,351774938,528366556,488366556,12.2091639,2010,6
77,2010-09-24,Enter the Void,16000000,337997,1467278,1805275,-14194725,-0.8871703125,2010,9
77,2011-10-14,The Thing,38000000,16999934,27573078,44573012,6573012,0.172974,2011,10
77,2011-10-21,The Three Musketeers,90000000,20377913,139877913,160255826,70255826,0.7806202888888889,2011,10
77,2012-06-08,Safety Not Guaranteed,750000,4010957,4422318,8433275,7683275,10.244366666666666,2012,6
77,2012-06-22,Brave,185000000,237282182,554606532,791888714,606888714,3.280479535135135,2012,6
77,2012-09-21,The Perks of Being a Wallflower,13000000,17742948,33069303,50812251,37812251,2.9086346923076922,2012,9
77,2012-12-21,Cirque du Soleil: Worlds Away,25000000,12512862,28012862,40525724,15525724,0.62102896,2012,12
77,2013-04-05,Evil Dead,17000000,54239856,97778356,152018212,135018212,7.942247764705883,2013,4
77,2013-05-24,Epic,100000000,107518682,262794441,370313123,270313123,2.70313123,2013,5
77,2013-07-26,The To Do List,1500000,3491669,4128828,7620497,6120497,4.0803313333333335,2013,7
77,2013-12-25,Grudge Match,40000000,29807260,69807260,99614520,59614520,1.490363,2013,12
77,2014-12-25,Into the Woods,56200000,128002372,213116401,341118773,284918773,5.069729056939502,2014,12
77,2016-03-25,My Big Fat Greek Wedding 2,18000000,59689605,92096558,151786163,133786163,7.432564611111111,2016,3
77,2016-05-20,The Angry Birds Movie,73000000,107509366,352327887,459837253,386837253,5.299140452054795,2016,5
77,2016-08-12,Hell or High Water,12000000,27007844,37584304,64592148,52592148,4.382679,2016,8
77,2017-01-13,The Bye Bye Man,7400000,22395806,31187727,53583533,46183533,6.241017972972973,2017,1
77,2018-02-06,Blood Feast,1200000,8708,8708,17416,-1182584,-0.9854866666666666,2018,2
77,2018-07-13,Hotel Transylvania 3: Summer Vacation,65000000,167500092,527079962,694580054,629580054,9.685846984615385,2018,7
77,2019-04-12,Hellboy,50000000,21903748,40725492,62629240,12629240,0.2525848,2019,4
78,1915-02-08,The Birth of a Nation,110000,10000000,11000000,21000000,20890000,189.9090909090909,1915,2
78,1946-11-21,The Best Years of Our Lives,2100000,23600000,23600000,47200000,45100000,21.476190476190474,1946,11
78,1961-12-19,Pocketful of Miracles,2900000,5000000,5000000,10000000,7100000,2.4482758620689653,1961,12
78,1975-06-10,Love and Death,3000000,20123742,20123742,40247484,37247484,12.415828,1975,6
78,1989-11-17,Harlem Nights,30000000,60857262,95857262,156714524,126714524,4.223817466666667,1989,11
78,1991-03-22,Teenage Mutant Ninja Turtles II: The Secret of the Ooze,25000000,78656813,78656813,157313626,132313626,5.29254504,1991,3
78,1992-11-25,The Crying Game,4000000,62546695,62546695,125093390,121093390,30.2733475,1992,11
78,1993-10-01,Cool Runnings,14000000,68856263,155056263,223912526,209912526,14.993751857142858,1993,10
78,1996-06-21,Eraser,100000000,101295562,234400000,335695562,235695562,2.35695562,1996,6
78,1998-04-03,Lost In Space,80000000,69117629,136047317,205164946,125164946,1.564561825,1998,4
78,1998-08-07,Snake Eyes,73000000,55591409,103891409,159482818,86482818,1.1846961369863014,1998,8
78,1998-09-11,Cube,250000,489220,8969065,9458285,9208285,36.83314,1998,9
78,1999-03-05,Cruel Intentions,11000000,38665260,76238901,114904161,103904161,9.445832818181819,1999,3
78,2000-01-28,Eye of the Beholder,15000000,16500786,18260865,34761651,19761651,1.3174434,2000,1
78,2000-08-11,Bless the Child,40000000,29374178,40435694,69809872,29809872,0.7452468,2000,8
78,2001-06-29,crazy/beautiful,13000000,16929123,19929123,36858246,23858246,1.8352496923076924,2001,6
78,2001-08-22,Lisa Picard is Famous,1000000,113433,113433,226866,-773134,-0.773134,2001,8
78,2001-09-07,Rock Star,38000000,16991902,19317765,36309667,-1690333,-0.04448244736842105,2001,9
78,2002-09-27,Moonlight Mile,21000000,6830957,6830957,13661914,-7338086,-0.34943266666666667,2002,9
78,2002-10-25,Frida,12000000,25885000,56131239,82016239,70016239,5.834686583333333,2002,10
78,2002-12-20,Morvern Callar,6000000,267194,267194,534388,-5465612,-0.9109353333333333,2002,12
78,2003-01-17,Kangaroo Jack,60000000,66723216,90723216,157446432,97446432,1.6241072,2003,1
78,2003-04-11,Anger Management,56000000,135560942,195660942,331221884,275221884,4.9146765,2003,4
78,2003-11-07,Love Actually,45000000,59472278,248505300,307977578,262977578,5.843946177777778,2003,11
78,2003-12-19,Calendar Girls,10000000,31011616,93074616,124086232,114086232,11.4086232,2003,12
78,2004-08-27,Jet Li's Hero,17000000,53652140,177535958,231188098,214188098,12.599299882352941,2004,8
78,2005-08-05,The Chumscrubber,6800000,49526,49526,99052,-6700948,-0.9854335294117647,2005,8
78,2006-08-04,Barnyard: The Original Party Animals,51000000,72779000,118583844,191362844,140362844,2.7522126274509806,2006,8
78,2006-08-11,Casa de Areia,3750000,539285,1178175,1717460,-2032540,-0.5420106666666666,2006,8
78,2007-04-27,Ta Ra Rum Pum,7400000,872643,9443864,10316507,2916507,0.3941225675675676,2007,4
78,2008-12-31,Good,16000000,31631,31631,63262,-15936738,-0.996046125,2008,12
78,2010-09-24,You Again,20000000,25702053,32838945,58540998,38540998,1.9270499,2010,9
78,2011-02-11,Certifiably Jonathan,1200000,7826,7826,15652,-1184348,-0.9869566666666667,2011,2
78,2011-04-08,Your Highness,50000000,21596445,26121638,47718083,-2281917,-0.04563834,2011,4
78,2011-08-26,Our Idiot Brother,5000000,24814830,25861249,50676079,45676079,9.1352158,2011,8
78,2011-09-09,Bucky Larson: Born to Be a Star,10000000,2529395,2529395,5058790,-4941210,-0.494121,2011,9
78,2012-02-03,The Innkeepers,750000,78396,1011535,1089931,339931,0.45324133333333333,2012,2
78,2012-04-27,Safe,33000000,17142080,41495213,58637293,25637293,0.7768876666666666,2012,4
78,2012-09-07,The Cold Light of Day,20000000,3763583,25361206,29124789,9124789,0.45623945,2012,9
78,2012-12-25,Les Miserables,65000000,148809770,442169052,590978822,525978822,8.091981876923077,2012,12
78,2013-02-01,The Gatekeepers,1500000,2408553,2592308,5000861,3500861,2.3339073333333333,2013,2
78,2013-03-08,Dead Man Down,30000000,10895295,19599974,30495269,495269,0.016508966666666666,2013,3
78,2014-01-31,That Awkward Moment,8000000,26068955,53068955,79137910,71137910,8.89223875,2014,1
78,2014-10-17,Rudderless,5000000,56001,567219,623220,-4376780,-0.875356,2014,10
78,2015-02-13,Fifty Shades of Grey,40000000,166167230,570998101,737165331,697165331,17.429133275,2015,2
78,2015-09-11,The Perfect Guy,18000000,57027435,60278166,117305601,99305601,5.516977833333334,2015,9
78,2015-10-30,Our Brand is Crisis,28000000,7002261,8594558,15596819,-12403181,-0.44297075,2015,10
78,2015-11-13,The 33,25000000,12227722,28400715,40628437,15628437,0.62513748,2015,11
78,2017-03-10,Kong: Skull Island,185000000,168052812,561072059,729124871,544124871,2.941215518918919,2017,3
78,2017-04-21,The Promise,90000000,8224288,10551417,18775705,-71224295,-0.7913810555555556,2017,4
78,2018-03-29,Ready Player One,150000000,137690172,579290136,716980308,566980308,3.77986872,2018,3
78,2018-07-13,Skyscraper,125000000,68420120,304115534,372535654,247535654,1.980285232,2018,7
78,2018-08-17,Mile 22,35000000,36108758,66295121,102403879,67403879,1.9258251142857143,2018,8
78,2018-10-05,The Hate U Give,23000000,29719483,35067665,64787148,41787148,1.8168325217391303,2018,10
78,2019-02-13,Happy Death Day 2U,9000000,28051045,64179495,92230540,83230540,9.247837777777777,2019,2
79,1985-06-21,Lifeforce,25000000,11603545,11603545,23207090,-1792910,-0.0717164,1985,6
79,1986-08-01,Friday the 13th Part VI: Jason Lives,3000000,19472057,19472057,38944114,35944114,11.981371333333334,1986,8
79,1996-02-02,White Squall,38000000,10229300,10229300,20458600,-17541400,-0.4616157894736842,1996,2
79,1996-06-21,The Hunchback of Notre Dame,100000000,100138851,325500000,425638851,325638851,3.25638851,1996,6
79,1996-08-09,Jack,45000000,58617334,58617334,117234668,72234668,1.6052148444444445,1996,8
79,1997-03-28,Love and Other Catastrophes,250000,212285,743216,955501,705501,2.822004,1997,3
79,1997-05-02,Austin Powers: International Man of Mystery,18000000,53883989,67683989,121567978,103567978,5.753776555555556,1997,5
79,1997-12-25,Kundun,28000000,5686694,5686694,11373388,-16626612,-0.5938075714285714,1997,12
79,1998-02-13,Sphere,73000000,37068294,50168294,87236588,14236588,0.19502175342465752,1998,2
79,1998-06-26,Buffalo '66,1500000,2380606,2380606,4761212,3261212,2.1741413333333335,1998,6
79,1998-08-28,54,13000000,16757163,16757163,33514326,20514326,1.578025076923077,1998,8
79,1999-04-02,Following,6000,48482,240495,288977,282977,47.16283333333333,1999,4
79,1999-11-12,Dogma,10000000,30651422,43948865,74600287,64600287,6.4600287,1999,11
79,2000-10-06,Bamboozled,10000000,2185266,2373937,4559203,-5440797,-0.5440797,2000,10
79,2001-03-30,Someone Like You,23000000,27338033,38684906,66022939,43022939,1.8705625652173914,2001,3
79,2001-07-13,Bully,2100000,881824,1381824,2263648,163648,0.07792761904761905,2001,7
79,2002-11-01,The Santa Clause 2,65000000,139225854,172825854,312051708,247051708,3.8007955076923077,2002,11
79,2003-09-12,Lost in Translation,4000000,44585453,117085297,161670750,157670750,39.4176875,2003,9
79,2003-10-03,The Work and the Story,103000,16137,16137,32274,-70726,-0.6866601941747573,2003,10
79,2003-10-10,The Flower of Evil,6000000,181798,181798,363596,-5636404,-0.9394006666666667,2003,10
79,2004-04-09,Shade,6800000,25032,9533964,9558996,2758996,0.40573470588235294,2004,4
79,2004-07-30,The Manchurian Candidate,80000000,65948711,96148711,162097422,82097422,1.026217775,2004,7
79,2005-01-28,Fascination,5000000,16670,83356,100026,-4899974,-0.9799948,2005,1
79,2005-03-04,The Pacifier,56000000,113006880,198006880,311013760,255013760,4.553817142857143,2005,3
79,2005-05-06,Crash,7303082,55334418,101173038,156507456,149204374,20.430329825134102,2005,5
79,2005-11-04,Chicken Little,150000000,135386665,310043823,445430488,295430488,1.9695365866666668,2005,11
79,2005-11-23,Rent,40000000,29077547,31670620,60748167,20748167,0.518704175,2005,11
79,2006-03-24,Boynton Beach Club,2900000,3127472,3127472,6254944,3354944,1.1568772413793103,2006,3
79,2007-01-12,Stomp the Yard,14000000,61356221,75525718,136881939,122881939,8.777281357142858,2007,1
79,2007-06-15,Nancy Drew,20000000,25584685,30703845,56288530,36288530,1.8144265,2007,6
79,2007-06-22,Sicko,9000000,24538513,36535837,61074350,52074350,5.786038888888889,2007,6
79,2008-03-14,Doomsday,33000000,11008770,21621188,32629958,-370042,-0.01121339393939394,2008,3
79,2008-03-21,Shutter,8000000,25928550,47782426,73710976,65710976,8.213872,2008,3
79,2008-04-25,Baby Mama,30000000,60494212,64170447,124664659,94664659,3.1554886333333334,2008,4
79,2008-06-13,The Happening,60000000,64506874,162778384,227285258,167285258,2.7880876333333333,2008,6
79,2009-05-15,The Brothers Bloom,20000000,3531756,5531756,9063512,-10936488,-0.5468244,2009,5
79,2009-06-19,The Proposal,40000000,163958031,314709717,478667748,438667748,10.9666937,2009,6
79,2010-10-29,Saw 3D,17000000,45710178,133735284,179445462,162445462,9.555615411764705,2010,10
79,2010-11-05,Four Lions,3750000,310007,2436111,2746118,-1003882,-0.2677018666666667,2010,11
79,2010-11-24,The Nutcracker in 3D,90000000,195459,20466016,20661475,-69338525,-0.7704280555555556,2010,11
79,2011-04-29,Hoodwinked Too: Hood vs. Evil,30000000,10143779,23353111,33496890,3496890,0.116563,2011,4
79,2011-05-06,The Beaver,21000000,970816,5046038,6016854,-14983146,-0.7134831428571429,2011,5
79,2012-07-05,Katy Perry: Part of Me,12000000,25326071,32700439,58026510,46026510,3.8355425,2012,7
79,2012-08-03,Total Recall,125000000,58877969,211856088,270734057,145734057,1.165872456,2012,8
79,2012-11-02,The Man with the Iron Fists,15000000,15634090,22018988,37653078,22653078,1.5102052,2012,11
79,2012-11-02,Vamps,16000000,3361,94812,98173,-15901827,-0.9938641875,2012,11
79,2012-12-25,Parental Guidance,25000000,77267296,120832383,198099679,173099679,6.92398716,2012,12
79,2014-08-29,Il conformista,750000,59656,89609,149265,-600735,-0.80098,2014,8
79,2015-05-08,Hot Pursuit,35000000,34580201,45671512,80251713,45251713,1.2929060857142858,2015,5
79,2015-07-31,Beyond the Brick: A LEGO Brickumentary,1000000,101531,101531,203062,-796938,-0.796938,2015,7
79,2015-09-18,La navaja de Don Juan,1200000,4254,4254,8508,-1191492,-0.99291,2015,9
79,2015-11-04,Brooklyn,11000000,38322743,62076141,100398884,89398884,8.127171272727272,2015,11
79,2016-07-22,Star Trek Beyond,185000000,158848340,335802233,494650573,309650573,1.673786881081081,2016,7
79,2016-09-16,Snowden,50000000,21587519,35380918,56968437,6968437,0.13936874,2016,9
79,2018-03-09,The Strangers: Prey at Night,5000000,24431472,29960051,54391523,49391523,9.8783046,2018,3
79,2018-08-17,Alpha,51000000,35851379,99624873,135476252,84476252,1.6563970980392158,2018,8
80,1977-04-20,Annie Hall,4000000,38251425,38251425,76502850,72502850,18.1257125,1977,4
80,1981-02-11,Sphinx,10000000,2000000,11400000,13400000,3400000,0.34,1981,2
80,1981-12-25,Modern Problems,8000000,24474312,24474312,48948624,40948624,5.118578,1981,12
80,1984-03-02,Repo Man,1500000,2300000,2300000,4600000,3100000,2.066666666666667,1984,3
80,1984-05-11,Firestarter,15000000,15136870,15136870,30273740,15273740,1.0182493333333333,1984,5
80,1987-06-03,The Untouchables,25000000,76270454,76270454,152540908,127540908,5.10163632,1987,6
80,1990-06-01,Total Recall,65000000,119394839,261400000,380794839,315794839,4.858382138461539,1990,6
80,1994-10-07,The Specialist,45000000,57362581,57362581,114725162,69725162,1.5494480444444445,1994,10
80,1998-05-29,Hope Floats,30000000,60110313,81529000,141639313,111639313,3.721310433333333,1998,5
80,1998-08-28,I Married a Strange Person,250000,203134,203134,406268,156268,0.625072,1998,8
80,1999-04-02,The Out-of-Towners,40000000,28544120,28544120,57088240,17088240,0.427206,1999,4
80,1999-04-23,Pushing Tin,33000000,8408835,8408835,16817670,-16182330,-0.49037363636363634,1999,4
80,2000-12-15,The Emperor's New Groove,100000000,89296573,169296573,258593146,158593146,1.58593146,2000,12
80,2002-05-29,Elling,2100000,313436,313436,626872,-1473128,-0.7014895238095238,2002,5
80,2002-08-02,Martin Lawrence Live: RunTelDat,3000000,19184820,19184820,38369640,35369640,11.78988,2002,8
80,2002-11-15,Interview with the Assassin,750000,47329,47329,94658,-655342,-0.8737893333333333,2002,11
80,2004-04-02,Walking Tall,56000000,46213824,47313824,93527648,37527648,0.6701365714285714,2004,4
80,2005-07-13,Return to the Land of Wonders,5000,1338,1338,2676,-2324,-0.4648,2005,7
80,2006-05-05,Mission: Impossible III,150000000,133501348,397501348,531002696,381002696,2.5400179733333332,2006,5
80,2006-07-21,Clerks II,5000000,24148068,27342246,51490314,46490314,9.2980628,2006,7
80,2006-11-22,Deck the Halls,51000000,35093569,46815807,81909376,30909376,0.6060661960784314,2006,11
80,2006-11-22,DÃ©jÃ Vu,80000000,64038616,181038616,245077232,165077232,2.0634654,2006,11
80,2007-07-27,The Simpsons Movie,72500000,183135014,527071022,710206036,637706036,8.79594532413793,2007,7
80,2007-12-25,Persepolis,7300000,4443403,25397187,29840590,22540590,3.0877520547945205,2007,12
80,2008-10-03,How to Lose Friends & Alienate People,28000000,2775593,12031443,14807036,-13192964,-0.4711772857142857,2008,10
80,2008-10-10,City of Ember,38000000,7873007,17831558,25704565,-12295435,-0.32356407894736844,2008,10
80,2008-10-17,The Secret Life of Bees,11000000,37780486,39994347,77774833,66774833,6.070439363636364,2008,10
80,2008-10-24,"Synecdoche, New York",20000000,3083538,4383538,7467076,-12532924,-0.6266462,2008,10
80,2009-01-16,My Bloody Valentine,14000000,51545952,102836002,154381954,140381954,10.027282428571429,2009,1
80,2009-04-10,Dragonball Evolution,30000000,9362785,58228460,67591245,37591245,1.2530415,2009,4
80,2009-08-14,Grace,5000000,8297,8297,16594,-4983406,-0.9966812,2009,8
80,2009-10-30,The House of the Devil,1000000,101215,102812,204027,-795973,-0.795973,2009,10
80,2010-02-19,Defendor,3750000,44462,44462,88924,-3661076,-0.9762869333333334,2010,2
80,2010-09-10,Bran Nue Dae,6750000,113568,6812530,6926098,176098,0.026088592592592594,2010,9
80,2010-09-17,Alpha and Omega 3D,20000000,25107267,48958353,74065620,54065620,2.703281,2010,9
80,2010-10-01,Freakonomics,2900000,101270,172867,274137,-2625863,-0.90547,2010,10
80,2011-03-04,Akmareul Boatda,6000000,129210,13168809,13298019,7298019,1.2163365,2011,3
80,2011-03-25,Diary of a Wimpy Kid: Rodrick Rules,18000000,52698535,73695194,126393729,108393729,6.021873833333333,2011,3
80,2011-04-15,The Conspirator,25000000,11538204,15907411,27445615,2445615,0.0978246,2011,4
80,2011-09-30,Dream House,50000000,21302340,41642166,62944506,12944506,0.25889012,2011,9
80,2013-12-13,American Hustle,40000000,150117807,257878294,407996101,367996101,9.199902525,2013,12
80,2014-01-10,Her,23000000,25568251,48163815,73732066,50732066,2.205742,2014,1
80,2014-12-12,Top Five,12000000,25317379,26001741,51319120,39319120,3.2765933333333335,2014,12
80,2015-01-30,Black or White,9000000,21571189,21971021,43542210,34542210,3.838023333333333,2015,1
80,2015-02-20,"McFarland, USA",17000000,44480275,45707924,90188199,73188199,4.305188176470589,2015,2
80,2015-07-10,The Gallows,100000,22764410,41656474,64420884,64320884,643.20884,2015,7
80,2015-10-16,Room,13000000,14677674,36262783,50940457,37940457,2.9184966923076923,2015,10
80,2015-12-25,Concussion,35000000,34531832,50363790,84895622,49895622,1.4255892,2015,12
80,2016-03-04,London Has Fallen,60000000,62524260,195194085,257718345,197718345,3.29530575,2016,3
80,2016-12-21,Assassinâs Creed,125000000,54647948,240759682,295407630,170407630,1.36326104,2016,12
80,2017-02-24,Bitter Harvest,21000000,557241,606162,1163403,-19836597,-0.9445998571428571,2017,2
80,2017-10-06,Blade Runner 2049,185000000,92054159,259357408,351411567,166411567,0.8995219837837838,2017,10
80,2018-08-10,Slender Man,10000000,30564825,51723644,82288469,72288469,7.2288469,2018,8
81,1960-06-15,The Apartment,3000000,18600000,24600000,43200000,40200000,13.4,1960,6
81,1969-12-18,On Her Majesty's Secret Service,8000000,22800000,82000000,104800000,96800000,12.1,1969,12
81,1970-05-13,The Ballad of Cable Hogue,3716946,3500000,5000000,8500000,4783054,1.2868236450031827,1970,5
81,1984-09-19,Amadeus,18000000,51973029,51973029,103946058,85946058,4.774781,1984,9
81,1997-10-31,Switchback,38000000,6504442,6504442,13008884,-24991116,-0.6576609473684211,1997,10
81,1998-04-08,The Players Club,5000000,23047939,23047939,46095878,41095878,8.2191756,1998,4
81,1998-09-11,Rounders,12000000,22921898,22921898,45843796,33843796,2.8203163333333334,1998,9
81,1998-12-18,You've Got Mail,65000000,115821495,250800000,366621495,301621495,4.640330692307693,1998,12
81,1999-10-22,Molly,21000000,17396,17396,34792,-20965208,-0.9983432380952381,1999,10
81,2000-01-21,Down to You,9000000,20035310,20035310,40070620,31070620,3.452291111111111,2000,1
81,2000-04-07,Rules of Engagement,60000000,61322858,71719931,133042789,73042789,1.2173798166666667,2000,4
81,2001-10-05,Joy Ride,23000000,21973182,21973182,43946364,20946364,0.9107114782608695,2001,10
81,2002-07-03,The Powerpuff Girls,25000000,11411644,16425701,27837345,2837345,0.1134938,2002,7
81,2002-09-20,The Banger Sisters,10000000,30306281,38067218,68373499,58373499,5.8373499,2002,9
81,2004-09-03,"Remember Me, My Love",6700000,223878,223878,447756,-6252244,-0.9331707462686567,2004,9
81,2004-09-24,First Daughter,30000000,9055010,10419084,19474094,-10525906,-0.3508635333333333,2004,9
81,2005-07-01,Undead,750000,41196,229250,270446,-479554,-0.6394053333333334,2005,7
81,2005-07-22,November,250000,191862,191862,383724,133724,0.534896,2005,7
81,2006-05-12,Goal! The Dream Begins,33000000,4283255,27610873,31894128,-1105872,-0.03351127272727273,2006,5
81,2006-09-29,Facing the Giants,100000,10178331,10243159,20421490,20321490,203.2149,2006,9
81,2006-11-10,Come Early Morning,6000000,119452,119452,238904,-5761096,-0.9601826666666666,2006,11
81,2007-11-09,No Country for Old Men,25000000,74273505,164035753,238309258,213309258,8.53237032,2007,11
81,2008-02-08,Fool's Gold,72500000,70231041,109362966,179594007,107094007,1.4771587172413794,2008,2
81,2009-01-09,Bride Wars,30000000,58715510,115150424,173865934,143865934,4.795531133333333,2009,1
81,2009-05-15,Angels & Demons,150000000,133375846,490875846,624251692,474251692,3.1616779466666665,2009,5
81,2010-04-30,Harry Brown,7300000,1818681,12023606,13842287,6542287,0.8962036986301369,2010,4
81,2011-03-04,The Adjustment Bureau,50200000,62495645,126931325,189426970,139226970,2.7734456175298803,2011,3
81,2011-08-19,Griff the Invisible,2900000,20778,25935,46713,-2853287,-0.9838920689655173,2011,8
81,2012-06-01,Hardflip,1000000,96734,96734,193468,-806532,-0.806532,2012,6
81,2012-08-17,The Expendables 2,100000000,85028192,311979256,397007448,297007448,2.97007448,2012,8
81,2012-08-31,The Possession,14000000,49130588,82925064,132055652,118055652,8.43254657142857,2012,8
81,2013-05-03,The Iceman,10000000,1930282,3623609,5553891,-4446109,-0.4446109,2013,5
81,2015-01-23,The Boy Next Door,4000000,36006065,53401938,89408003,85408003,21.35200075,2015,1
81,2015-04-01,Woman in Gold,11000000,33307793,58586407,91894200,80894200,7.354018181818182,2015,4
81,2015-05-15,Area 51,5000000,7556,7556,15112,-4984888,-0.9969776,2015,5
81,2015-10-16,Woodlawn,13000000,14394097,14403703,28797800,15797800,1.2152153846153846,2015,10
81,2016-01-22,Zhuo yao ji,56000000,32766,359495591,359528357,303528357,5.420149232142857,2016,1
81,2016-06-24,Free State of Jones,50000000,20810036,23237252,44047288,-5952712,-0.11905424,2016,6
81,2016-10-16,Mi America,2100000,3330,3330,6660,-2093340,-0.9968285714285714,2016,10
81,2016-10-21,Iâm Not Ashamed,1500000,2082980,2082980,4165960,2665960,1.7773066666666666,2016,10
81,2016-11-11,Almost Christmas,17000000,42065185,42493506,84558691,67558691,3.9740406470588234,2016,11
81,2016-12-09,Office Christmas Party,45000000,54767494,91323299,146090793,101090793,2.2464620666666666,2016,12
81,2017-01-13,Monster Trucks,125000000,33370166,61642798,95012964,-29987036,-0.239896288,2017,1
81,2017-08-11,The Nut Job 2: Nutty by Nature,40000000,28370522,57438389,85808911,45808911,1.145222775,2017,8
81,2017-10-13,The Foreigner,35000000,34393507,140783360,175176867,140176867,4.005053342857143,2017,10
81,2018-10-26,Suspiria,20000000,2483472,7034615,9518087,-10481913,-0.52409565,2018,10
81,2018-12-25,On the Basis of Sex,20000000,24622687,38073377,62696064,42696064,2.1348032,2018,12
81,2019-02-01,Miss Bala,15000000,14998027,15362298,30360325,15360325,1.0240216666666666,2019,2
81,2019-05-17,John Wick: Chapter 3 â Parabellum,40000000,141744320,256498033,398242353,358242353,8.956058825,2019,5
81,2019-05-24,Aladdin,182000000,246734314,619234314,865968628,683968628,3.7580693846153848,2019,5
81,2019-06-07,The Secret Life of Pets 2,80000000,63795655,113351496,177147151,97147151,1.2143393875,2019,6
82,1948-05-20,The Pirate,3700000,2956000,2956000,5912000,2212000,0.5978378378378378,1948,5
82,1952-01-10,The Greatest Show on Earth,4000000,36000000,36000000,72000000,68000000,17.0,1952,1
82,1958-09-20,Cat on a Hot Tin Roof,3000000,17570324,17570324,35140648,32140648,10.713549333333333,1958,9
82,1959-03-29,Some Like it Hot,2883848,25000000,25019542,50019542,47135694,16.344722051925068,1959,3
82,1967-04-28,Casino Royale,12000000,22744718,41744718,64489436,52489436,4.374119666666667,1967,4
82,1977-01-01,Eraserhead,100000,7000000,7014590,14014590,13914590,139.1459,1977,1
82,1981-06-12,History of the World: Part I,11000000,31672000,31672000,63344000,52344000,4.758545454545454,1981,6
82,1982-10-22,First Blood,14000000,47212904,125212904,172425808,158425808,11.316129142857143,1982,10
82,1985-01-18,Blood Simple,1500000,1690913,2730877,4421790,2921790,1.94786,1985,1
82,1993-05-07,Much Ado About Nothing,8000000,22549338,22549338,45098676,37098676,4.6373345,1993,5
82,1994-07-06,Forrest Gump,55000000,330151138,679850637,1010001775,955001775,17.363668636363638,1994,7
82,1996-05-10,Twister,88000000,241688385,495700000,737388385,649388385,7.379413465909091,1996,5
82,1996-08-16,Tin Cup,45000000,53854588,75854588,129709176,84709176,1.8824261333333334,1996,8
82,1996-08-23,The Island of Dr. Moreau,40000000,27682712,27682712,55365424,15365424,0.3841356,1996,8
82,1999-08-27,The 13th Warrior,125000000,32698899,61698899,94397798,-30602202,-0.244817616,1999,8
82,1999-09-17,Sugar Town,250000,178095,178095,356190,106190,0.42476,1999,9
82,2000-10-13,Billy Elliot,5000000,21995263,109253745,131249008,126249008,25.2498016,2000,10
82,2000-12-08,Snatch,10000000,30093107,83593107,113686214,103686214,10.3686214,2000,12
82,2001-04-13,Bridget Jones's Diary,25000000,71500556,281527158,353027714,328027714,13.12110856,2001,4
82,2003-12-25,Cheaper by the Dozen,40000000,138614544,190212113,328826657,288826657,7.220666425,2003,12
82,2004-05-14,Troy,150000000,133298577,484161265,617459842,467459842,3.1163989466666666,2004,5
82,2004-07-30,Harold & Kumar Go to White Castle,9000000,18225165,18225165,36450330,27450330,3.0500366666666667,2004,7
82,2004-08-20,Without a Paddle,30000000,58156435,65121280,123277715,93277715,3.1092571666666666,2004,8
82,2004-12-03,Closer,35000000,33987757,116177695,150165452,115165452,3.2904414857142856,2004,12
82,2005-06-03,The Lords of Dogtown,25000000,11273517,13424365,24697882,-302118,-0.01208472,2005,6
82,2005-06-24,Bewitched,80000000,63313159,131159306,194472465,114472465,1.4309058125,2005,6
82,2005-08-05,My Date With Drew,1100,181041,181041,362082,360982,328.16545454545457,2005,8
82,2006-03-10,The Hills Have Eyes,17000000,41778863,70355813,112134676,95134676,5.596157411764706,2006,3
82,2006-03-10,The Shaggy Dog,60000000,61123569,87123569,148247138,88247138,1.4707856333333333,2006,3
82,2006-12-20,Letters from Iwo Jima,13000000,13756082,67867998,81624080,68624080,5.278775384615384,2006,12
82,2007-06-01,Knocked Up,27500000,148761765,219265952,368027717,340527717,12.382826072727273,2007,6
82,2008-04-11,Prom Night,18000000,43869350,57193655,101063005,83063005,4.614611388888889,2008,4
82,2009-01-23,Donkey Punch,750000,19367,814801,834168,84168,0.112224,2009,1
82,2009-07-31,Funny People,72500000,51855045,71880305,123735350,51235350,0.7066944827586207,2009,7
82,2009-09-04,Gamer,50000000,20534907,42002029,62536936,12536936,0.25073872,2009,9
82,2009-10-16,Where the Wild Things Are,100000000,77233467,99123656,176357123,76357123,0.76357123,2009,10
82,2009-11-20,The Twilight Saga: New Moon,50000000,296623634,687557727,984181361,934181361,18.68362722,2009,11
82,2010-04-02,The Greatest,6000000,115862,117796,233658,-5766342,-0.961057,2010,4
82,2010-05-21,Perrierâs Bounty,6600000,828,828,1656,-6598344,-0.9997490909090909,2010,5
82,2012-02-17,Kari gurashi no Arietti,23000000,19192510,151496097,170688607,147688607,6.421243782608696,2012,2
82,2012-11-30,Killing Them Softly,15000000,14945541,39238443,54183984,39183984,2.6122656,2012,11
82,2014-02-14,Endless Love,20000000,23438250,34718173,58156423,38156423,1.90782115,2014,2
82,2014-12-25,Unbroken,65000000,115637895,163527824,279165719,214165719,3.2948572153846154,2014,12
82,2015-06-05,Testament of Youth,10000000,1822250,6646669,8468919,-1531081,-0.1531081,2015,6
82,2015-07-31,The Young and Prodigious T.S. Spivet,33000000,176847,357687,534534,-32465466,-0.983802,2015,7
82,2016-03-11,Creative Control,1000000,63014,63014,126028,-873972,-0.873972,2016,3
82,2017-04-14,The Lost City of Z,30000000,8574339,17121823,25696162,-4303838,-0.14346126666666667,2017,4
82,2017-11-03,LBJ,20000000,2468683,2507181,4975864,-15024136,-0.7512068,2017,11
82,2017-11-03,Thor: Ragnarok,180000000,315058289,846980024,1162038313,982038313,5.455768405555555,2017,11
82,2018-09-21,The Sisters Brothers,38000000,3143056,13143056,16286112,-21713888,-0.571418105263158,2018,9
83,1970-05-26,Beneath the Planet of the Apes,3000000,17489009,17489009,34978018,31978018,10.659339333333333,1970,5
83,1971-12-17,Diamonds Are Forever,7200000,43800000,116000000,159800000,152600000,21.194444444444443,1971,12
83,1977-07-13,The Spy Who Loved Me,14000000,46800000,185400000,232200000,218200000,15.585714285714285,1977,7
83,1979-06-15,Prophecy,12000000,22673340,22673340,45346680,33346680,2.77889,1979,6
83,1983-06-10,Octopussy,27500000,67900000,187500000,255400000,227900000,8.287272727272727,1983,6
83,1986-07-01,Big Trouble in Little China,25000000,11100000,11100000,22200000,-2800000,-0.112,1986,7
83,1987-03-01,Hollywood Shuffle,100000,5228617,5228617,10457234,10357234,103.57234,1987,3
83,1989-05-19,Road House,10000000,30050028,30050028,60100056,50100056,5.0100056,1989,5
83,1992-04-10,The Player,8000000,21706101,28876702,50582803,42582803,5.322850375,1992,4
83,1994-12-23,Street Fighter,35000000,33423000,99423000,132846000,97846000,2.7956,1994,12
83,1995-10-27,Leaving Las Vegas,4000000,31983777,49800000,81783777,77783777,19.44594425,1995,10
83,1996-11-22,Jingle All the Way,60000000,60592389,129832389,190424778,130424778,2.1737463,1996,11
83,1999-04-23,eXistenZ,20700000,2840417,2840417,5680834,-15019166,-0.7255635748792271,1999,4
83,1999-10-29,Mononoke-hime,20000000,2374107,150350000,152724107,132724107,6.63620535,1999,10
83,2000-10-13,The Contender,9000000,17804273,17804273,35608546,26608546,2.956505111111111,2000,10
83,2000-11-17,How the Grinch Stole Christmas,123000000,260044825,345141403,605186228,482186228,3.9202132357723576,2000,11
83,2000-12-15,Chocolat,25000000,71309760,152500343,223810103,198810103,7.95240412,2000,12
83,2001-04-20,Freddy Got Fingered,15000000,14249005,14249005,28498010,13498010,0.8998673333333334,2001,4
83,2001-05-18,Shrek,50000000,267655011,491812794,759467805,709467805,14.1893561,2001,5
83,2001-09-07,The Musketeer,40000000,27053815,27053815,54107630,14107630,0.35269075,2001,9
83,2001-11-30,Texas Rangers,38000000,623374,623374,1246748,-36753252,-0.9671908421052632,2001,11
83,2002-03-01,40 Days and 40 Nights,17000000,37939782,95092667,133032449,116032449,6.8254381764705885,2002,3
83,2002-03-08,The Time Machine,80000000,56684819,98983590,155668409,75668409,0.9458551125,2002,3
83,2002-04-19,Nueve Reinas,1500000,1222889,12412889,13635778,12135778,8.090518666666666,2002,4
83,2005-02-25,Man of the House,50000000,19699706,22099706,41799412,-8200588,-0.16401176,2005,2
83,2005-06-03,Cinderella Man,88000000,61649911,105021488,166671399,78671399,0.8939931704545454,2005,6
83,2005-06-10,High Tension,2850000,3681066,6435262,10116328,7266328,2.5495887719298245,2005,6
83,2005-09-09,An Unfinished Life,30000000,8535575,18535575,27071150,-2928850,-0.09762833333333333,2005,9
83,2005-09-16,Chocolate: Deep Dark Secrets,1000000,49000,1549000,1598000,598000,0.598,2005,9
83,2005-11-23,"Yours, Mine and Ours",45000000,53359917,72359917,125719834,80719834,1.793774088888889,2005,11
83,2005-12-09,"The Chronicles of Narnia: The Lion, the Witch and the Wardrobe",180000000,291710957,720539572,1012250529,832250529,4.62361405,2005,12
83,2006-09-08,The Covenant,20000000,23364784,38164784,61529568,41529568,2.0764784,2006,9
83,2006-11-21,The History Boys,3700000,2730296,13447998,16178294,12478294,3.3725118918918917,2006,11
83,2006-12-15,Eragon,100000000,75030163,249488115,324518278,224518278,2.24518278,2006,12
83,2007-09-28,The Kingdom,72500000,47467250,86509602,133976852,61476852,0.8479565793103448,2007,9
83,2007-12-14,Alvin and the Chipmunks,55000000,217326974,362605033,579932007,524932007,9.544218309090908,2007,12
83,2008-03-28,Happy Valley,250000,67665,67665,135330,-114670,-0.45868,2008,3
83,2008-09-19,Tropa de Elite,6537890,8744,14319195,14327939,7790049,1.1915234119876597,2008,9
83,2009-05-29,MÃ¤n som hatar kvinnor,13000000,12749992,109421911,122171903,109171903,8.397838692307692,2009,5
83,2010-07-01,The Last Airbender,150000000,131772187,319713881,451486068,301486068,2.00990712,2010,7
83,2011-04-08,Soul Surfer,18000000,43853424,47158652,91012076,73012076,4.0562264444444445,2011,4
83,2011-05-20,Midnight in Paris,30000000,56816662,162502774,219319436,189319436,6.310647866666667,2011,5
83,2012-01-20,Haywire,23000000,18942396,36374700,55317096,32317096,1.4050911304347826,2012,1
83,2012-12-07,Deadfall,6000000,66351,1673635,1739986,-4260014,-0.7100023333333333,2012,12
83,2013-07-05,The Way Way Back,5000000,21502690,26853810,48356500,43356500,8.6713,2013,7
83,2014-07-25,Lucy,40000000,126573960,457507776,584081736,544081736,13.6020434,2014,7
83,2015-06-05,Spy!,65000000,110825712,232585748,343411460,278411460,4.283253230769231,2015,6
83,2015-10-30,Freaks of Nature,33000000,70958,70958,141916,-32858084,-0.9956995151515151,2015,10
83,2017-04-21,Free Fire,10000000,1799322,3793739,5593061,-4406939,-0.4406939,2017,4
83,2017-12-08,"I, Tonya",11000000,30014534,53797409,83811943,72811943,6.619267545454545,2017,12
83,2018-12-21,Second Act,15700000,39282227,63288854,102571081,86871081,5.533189872611465,2018,12
84,1920-09-17,Over the Hill to the Poorhouse,100000,3000000,3000000,6000000,5900000,59.0,1920,9
84,1974-12-15,Young Frankenstein,2800000,86300000,86300000,172600000,169800000,60.642857142857146,1974,12
84,1982-07-23,The Best Little Whorehouse in Texas,20500000,69701637,69701637,139403274,118903274,5.800159707317073,1982,7
84,1982-11-10,Creepshow,8000000,20036244,20036244,40072488,32072488,4.009061,1982,11
84,1983-05-25,Star Wars Ep. VI: Return of the Jedi,32500000,309205079,572705079,881910158,849410158,26.13569716923077,1983,5
84,1996-10-11,Michael Collins,25000000,11092559,27572844,38665403,13665403,0.54661612,1996,10
84,1998-09-25,Urban Legend,14000000,38116707,72571864,110688571,96688571,6.9063265,1998,9
84,1998-10-02,What Dreams May Come,80000000,55485043,71485043,126970086,46970086,0.587126075,1998,10
84,1999-10-15,The Omega Code,7200000,12610552,12678312,25288864,18088864,2.5123422222222223,1999,10
84,1999-11-12,Anywhere But Here,23000000,18653615,18653615,37307230,14307230,0.6220534782608695,1999,11
84,2000-02-18,Boiler Room,9000000,16963963,28773637,45737600,36737600,4.081955555555555,2000,2
84,2000-05-24,Mission: Impossible 2,120000000,215409889,549588516,764998405,644998405,5.374986708333333,2000,5
84,2001-04-06,Pokemon 3: The Movie,3000000,17052128,68452128,85504256,82504256,27.501418666666666,2001,4
84,2001-06-22,Dr. Dolittle 2,72000000,112950721,176101721,289052442,217052442,3.01461725,2001,6
84,2001-11-21,Black Knight,35000000,33422806,33422806,66845612,31845612,0.9098746285714285,2001,11
84,2001-12-26,Monster's Ball,4000000,31273922,43766463,75040385,71040385,17.76009625,2001,12
84,2002-06-21,Juwanna Mann,15600000,13571817,13771817,27343634,11743634,0.7527970512820513,2002,6
84,2003-02-21,The Life of David Gale,50000000,19694635,28920188,48614823,-1385177,-0.02770354,2003,2
84,2003-09-26,Under the Tuscan Sun,18000000,43601508,57490024,101091532,83091532,4.616196222222222,2003,9
84,2003-10-10,Good Boy!,17000000,37667746,45312217,82979963,65979963,3.8811742941176472,2003,10
84,2004-03-19,Bon Voyage,20000000,2353728,8361736,10715464,-9284536,-0.4642268,2004,3
84,2004-04-02,Hellboy,60000000,59623958,99823958,159447916,99447916,1.6574652666666667,2004,4
84,2005-05-13,Kicking and Screaming,45000000,52842724,55842724,108685448,63685448,1.4152321777777779,2005,5
84,2006-11-03,Unknown,3700000,26403,3355048,3381451,-318549,-0.08609432432432433,2006,11
84,2007-02-23,The Astronaut Farmer,13000000,11003643,11141213,22144856,9144856,0.7034504615384616,2007,2
84,2007-11-02,Bee Movie,150000000,126631277,287594577,414225854,264225854,1.7615056933333333,2007,11
84,2009-05-08,Julia,6000000,65108,1365108,1430216,-4569784,-0.7616306666666667,2009,5
84,2009-06-26,My Sister's Keeper,27500000,49200230,96673002,145873232,118373232,4.304481163636364,2009,6
84,2009-10-23,Saw VI,11000000,27693292,69752402,97445694,86445694,7.858699454545454,2009,10
84,2010-11-05,Due Date,65000000,100539043,211739043,312278086,247278086,3.8042782461538462,2010,11
84,2011-01-21,No Strings Attached,25000000,70662220,149228078,219890298,194890298,7.79561192,2011,1
84,2011-06-24,A Better Life,10000000,1759252,1884251,3643503,-6356497,-0.6356497,2011,6
84,2011-07-01,The Perfect Host,1000000,48764,51587,100351,-899649,-0.899649,2011,7
84,2011-07-01,Monte Carlo,20000000,23186769,39686769,62873538,42873538,2.1436769,2011,7
84,2011-08-19,One Day,15000000,13843771,59168692,73012463,58012463,3.8674975333333332,2011,8
84,2012-06-29,Ted,50000000,218665740,556016627,774682367,724682367,14.49364734,2012,6
84,2013-04-19,The Lords of Salem,1500000,1165881,1541131,2707012,1207012,0.8046746666666666,2013,4
84,2013-08-02,The Canyons,250000,59671,62375,122046,-127954,-0.511816,2013,8
84,2013-12-25,Lone Survivor,40000000,125095601,149804632,274900233,234900233,5.872505825,2013,12
84,2014-05-30,Maleficent,180000000,241407328,758536735,999944063,819944063,4.5552447944444445,2014,5
84,2014-07-25,Hercules,100000000,72688614,243388614,316077228,216077228,2.16077228,2014,7
84,2014-08-29,"As Above, So Below",5000000,21222315,41824066,63046381,58046381,11.6092762,2014,8
84,2014-10-03,Annabelle,6500000,84273813,256862920,341136733,334636733,51.48257430769231,2014,10
84,2015-01-30,Project Almanac,12000000,22348241,32909437,55257678,43257678,3.6048065,2015,1
84,2017-01-27,Resident Evil: The Final Chapter,40000000,26844692,314101190,340945882,300945882,7.52364705,2017,1
84,2017-02-03,The Space Between Us,30000000,7885294,16481405,24366699,-5633301,-0.1877767,2017,2
84,2017-11-22,Darkest Hour,30000000,56443120,150807172,207250292,177250292,5.908343066666666,2017,11
84,2018-07-27,Teen Titans Go! To The Movies,10000000,29790236,51620593,81410829,71410829,7.1410829,2018,7
84,2018-09-14,The Predator,88000000,51024708,159487563,210512271,122512271,1.3921848977272728,2018,9
84,2018-11-02,Bohemian Rhapsody,55000000,216303339,894985342,1111288681,1056288681,19.205248745454547,2018,11
85,1969-05-25,Midnight Cowboy,3600000,44785053,44785053,89570106,85970106,23.880585,1969,5
85,1976-06-25,The Omen,2800000,48570885,48570885,97141770,94341770,33.693489285714286,1976,6
85,1981-12-09,Taps,14000000,35856053,35856053,71712106,57712106,4.122293285714286,1981,12
85,1989-11-22,Back to the Future Part II,40000000,118450002,332000000,450450002,410450002,10.26125005,1989,11
85,1993-08-13,Jason Goes to Hell: The Final Friday,3000000,15935068,15935068,31870136,28870136,9.623378666666667,1993,8
85,1995-05-24,Braveheart,72000000,75545647,209045244,284590891,212590891,2.952651263888889,1995,5
85,1998-06-12,Dirty Work,13000000,10020081,10020081,20040162,7040162,0.5415509230769231,1998,6
85,1998-09-25,The Last Big Thing,1000000,22434,22434,44868,-955132,-0.955132,1998,9
85,1998-10-09,The Mighty,100000,2652246,6121582,8773828,8673828,86.73828,1998,10
85,1998-12-25,Mighty Joe Young,80000000,50632037,50632037,101264074,21264074,0.265800925,1998,12
85,2000-06-30,The Perfect Storm,120000000,182618434,328711434,511329868,391329868,3.261082233333333,2000,6
85,2001-10-12,Corky Romano,11000000,23978402,25116103,49094505,38094505,3.4631368181818183,2001,10
85,2002-04-05,Lucky Break,6000000,54606,4316497,4371103,-1628897,-0.27148283333333334,2002,4
85,2003-02-28,Spider,10000000,1641788,1641788,3283576,-6716424,-0.6716424,2003,2
85,2004-06-25,De-Lovely,15000000,13337299,18524496,31861795,16861795,1.1241196666666666,2004,6
85,2004-09-01,Vanity Fair,23000000,16123851,19123851,35247702,12247702,0.5325087826086956,2004,9
85,2005-02-11,Hitch,55000000,177784257,366784257,544568514,489568514,8.90124570909091,2005,2
85,2005-04-29,The Hitchhiker's Guide to the Galaxy,45000000,51019112,102746214,153765326,108765326,2.4170072444444446,2005,4
85,2005-07-08,Fantastic Four,87500000,154696080,333132750,487828830,400328830,4.575186628571428,2005,7
85,2005-07-22,The Bad News Bears,35000000,32868349,33500620,66368969,31368969,0.8962562571428572,2005,7
85,2005-10-05,Wallace & Gromit: The Curse of the Were-Rabbit,30000000,56068547,197593152,253661699,223661699,7.455389966666667,2005,10
85,2006-03-24,Stay Alive,20000000,23086480,23187506,46273986,26273986,1.3136993,2006,3
85,2006-04-28,Akeelah and the Bee,8000000,18848430,18959424,37807854,29807854,3.72598175,2006,4
85,2006-06-28,The Motel,250000,51540,51540,103080,-146920,-0.58768,2006,6
85,2006-08-11,Pulse,20500000,20264436,30241435,50505871,30005871,1.463701024390244,2006,8
85,2006-12-05,Black Christmas,9000000,16235738,16235738,32471476,23471476,2.6079417777777776,2006,12
85,2007-01-26,Smokin' Aces,17000000,35662731,57263440,92926171,75926171,4.4662453529411765,2007,1
85,2007-06-08,La MÃ´me,15500000,10299782,88611837,98911619,83411619,5.381394774193549,2007,6
85,2008-02-01,Hannah Montana/Miley Cyrus: Best of Both Worlds Concert Tour,6500000,65281781,70712099,135993880,129493880,19.922135384615384,2008,2
85,2008-02-08,Welcome Home Roscoe Jenkins,27500000,42436517,43607627,86044144,58544144,2.1288779636363637,2008,2
85,2008-02-29,The Other Boleyn Girl,40000000,26814957,78269970,105084927,65084927,1.627123175,2008,2
85,2008-03-28,Stop-Loss,25000000,10915744,11229035,22144779,-2855221,-0.11420884,2008,3
85,2008-07-25,Step Brothers,65000000,100468793,128468793,228937586,163937586,2.522116707692308,2008,7
85,2009-07-24,G-Force,150000000,119436770,292817841,412254611,262254611,1.7483640733333334,2009,7
85,2009-12-25,The Imaginarium of Doctor Parnassus,30000000,7689607,64352607,72042214,42042214,1.4014071333333333,2009,12
85,2010-05-14,Just Wright,12000000,21540363,21867665,43408028,31408028,2.6173356666666665,2010,5
85,2010-12-10,The Tourist,100000000,67631157,278731369,346362526,246362526,2.46362526,2010,12
85,2011-05-13,Bridesmaids,32500000,169211718,289632023,458843741,426343741,13.118268953846155,2011,5
85,2011-09-16,3,7200000,59774,295492,355266,-6844734,-0.9506575,2011,9
85,2012-01-13,Contraband,25000000,66528000,98406855,164934855,139934855,5.5973942,2012,1
85,2013-02-14,Beautiful Creatures,50000000,19452138,60282876,79735014,29735014,0.59470028,2013,2
85,2014-06-13,22 Jump Street,50000000,191719337,331333876,523053213,473053213,9.46106426,2014,6
85,2014-07-11,Boyhood,4000000,25379975,57273049,82653024,78653024,19.663256,2014,7
85,2015-11-13,My All-American,20000000,2246000,2246000,4492000,-15508000,-0.7754,2015,11
85,2016-04-01,Godâs Not Dead 2,5000000,20773069,23551286,44324355,39324355,7.864871,2016,4
85,2016-09-09,When the Bough Breaks,10000000,29747603,30768449,60516052,50516052,5.0516052,2016,9
85,2016-10-21,31,1500000,779820,922727,1702547,202547,0.13503133333333334,2016,10
85,2016-10-21,Jack Reacher: Never Go Back,60000000,58697076,159946489,218643565,158643565,2.644059416666667,2016,10
85,2016-11-18,Fantastic Beasts and Where to Find Them,180000000,234037575,802402853,1036440428,856440428,4.758002377777777,2016,11
85,2018-06-29,Uncle Drew,18000000,42469946,46527161,88997107,70997107,3.944283722222222,2018,6
85,2019-01-11,The Upside,37500000,108235497,119024536,227260033,189760033,5.060267546666666,2019,1
86,1960-12-15,Exodus,4000000,21750000,21750000,43500000,39500000,9.875,1960,12
86,1980-06-20,Can't Stop the Music,20000000,2000000,2000000,4000000,-16000000,-0.8,1980,6
86,1983-06-24,Twilight Zone: The Movie,10000000,29500000,29500000,59000000,49000000,4.9,1983,6
86,1990-04-27,Spaced Invaders,3000000,15000000,15000000,30000000,27000000,9.0,1990,4
86,1991-06-14,Robin Hood: Prince of Thieves,50000000,165493908,390500000,555993908,505993908,10.11987816,1991,6
86,1991-07-12,Boyz n the Hood,6500000,56190094,56215095,112405189,105905189,16.293106,1991,7
86,1991-11-13,Beauty and the Beast,20000000,376057266,608431132,984488398,964488398,48.2244199,1991,11
86,1993-10-08,Gettysburg,25000000,10731997,10731997,21463994,-3536006,-0.14144024,1993,10
86,1994-10-14,Wes Craven's New Nightmare,8000000,18090181,18090181,36180362,28180362,3.52254525,1994,10
86,1995-12-15,Jumanji,65000000,100458310,262758310,363216620,298216620,4.587948,1995,12
86,1997-12-17,The Apostle,5000000,20733485,21277770,42011255,37011255,7.402251,1997,12
86,1998-08-07,Safe Men,1000000,21210,21210,42420,-957580,-0.95758,1998,8
86,1998-10-02,A Night at the Roxbury,17000000,30331165,30331165,60662330,43662330,2.5683723529411764,1998,10
86,1999-09-10,Stir of Echoes,12000000,21133087,21133087,42266174,30266174,2.5221811666666665,1999,9
86,1999-09-24,Double Jeopardy,40000000,116735231,177835231,294570462,254570462,6.36426155,1999,9
86,1999-11-24,End of Days,100000000,66889043,212026975,278916018,178916018,1.78916018,1999,11
86,2000-02-04,Gun Shy,10000000,1638202,1638202,3276404,-6723596,-0.6723596,2000,2
86,2000-10-06,Meet the Parents,55000000,166225040,330425040,496650080,441650080,8.030001454545454,2000,10
86,2001-02-09,Hannibal,87000000,165092266,350100280,515192546,428192546,4.921753402298851,2001,2
86,2002-11-15,Ararat,15500000,1693000,1693000,3386000,-12114000,-0.7815483870967742,2002,11
86,2002-12-27,The Pianist,35000000,32519322,111854182,144373504,109373504,3.124957257142857,2002,12
86,2005-03-25,The Ballad of Jack and Rose,1500000,712294,1126258,1838552,338552,0.22570133333333334,2005,3
86,2005-07-15,On the Outs,250000,49772,237816,287588,37588,0.150352,2005,7
86,2005-07-22,Hustle & Flow,2800000,22202809,23591783,45794592,42994592,15.355211428571428,2005,7
86,2005-09-30,Into the Blue,50000000,18782227,41982227,60764454,10764454,0.21528908,2005,9
86,2005-10-07,2 For the Money,20000000,22991379,30491379,53482758,33482758,1.6741379,2005,10
86,2005-10-28,The Legend of Zorro,80000000,45575336,141475336,187050672,107050672,1.3381334,2005,10
86,2005-11-04,Jarhead,72000000,62647540,96947540,159595080,87595080,1.2165983333333332,2005,11
86,2007-09-21,Resident Evil: Extinction,45000000,50648679,149871103,200519782,155519782,3.4559951555555557,2007,9
86,2007-12-05,Juno,7000000,143495265,231450102,374945367,367945367,52.56362385714286,2007,12
86,2007-12-21,P.S. I Love You,30000000,53695808,155769678,209465486,179465486,5.982182866666666,2007,12
86,2008-06-27,WALL-E,180000000,223808164,532508025,756316189,576316189,3.2017566055555555,2008,6
86,2008-09-05,"Surfer, Dude",6000000,36497,36497,72994,-5927006,-0.9878343333333334,2008,9
86,2008-10-10,Billy: The Early Years of Billy Graham,3600000,320896,320896,641792,-2958208,-0.8217244444444445,2008,10
86,2008-11-21,Bolt,150000000,114053579,328015029,442068608,292068608,1.9471240533333334,2008,11
86,2008-12-10,The Reader,32500000,34194407,112964875,147159282,114659282,3.527977907692308,2008,12
86,2009-10-02,Whip It,15000000,13077184,18889972,31967156,16967156,1.1311437333333334,2009,10
86,2011-01-14,Barney's Version,30000000,7502560,8845575,16348135,-13651865,-0.45506216666666666,2011,1
86,2012-01-13,Joyful Noise,27500000,30932113,31157914,62090027,34590027,1.2578191636363636,2012,1
86,2012-02-24,Tyler Perry's Good Deeds,14000000,35025791,35579177,70604968,56604968,4.043212,2012,2
86,2012-05-18,What to Expect When You're Expecting,37500000,41152203,88473016,129625219,92125219,2.4566725066666666,2012,5
86,2014-10-17,Birdman or (The Unexpected Virtue of Ignorance),18000000,42340598,103215094,145555692,127555692,7.086427333333333,2014,10
86,2015-07-17,Bajrangi Bhaijaan,13000000,8178001,121778347,129956348,116956348,8.996642153846153,2015,7
86,2016-02-26,Eddie the Eagle,23000000,15789389,45060480,60849869,37849869,1.6456464782608695,2016,2
86,2016-07-29,Jason Bourne,120000000,162192920,416168316,578361236,458361236,3.8196769666666666,2016,7
86,2016-11-18,The Edge of Seventeen,9000000,14431633,19096003,33527636,24527636,2.7252928888888888,2016,11
86,2017-01-27,A Dogâs Purpose,25000000,64321890,203671625,267993515,242993515,9.7197406,2017,1
86,2017-05-25,Baywatch,60000000,58060186,175863783,233923969,173923969,2.8987328166666666,2017,5
86,2017-06-30,The House,40000000,25584504,31192425,56776929,16776929,0.419423225,2017,6
86,2017-07-07,A Ghost Story,100000,1594798,2769782,4364580,4264580,42.6458,2017,7
86,2019-02-14,Fighting With My Family,11000000,22958583,39049922,62008505,51008505,4.637136818181818,2019,2
87,1968-06-25,La mariÃ©e Ã©tait en noir,747000,44566,44566,89132,-657868,-0.8806800535475234,1968,6
87,1972-03-15,The Godfather,7000000,134966411,268500000,403466411,396466411,56.63805871428571,1972,3
87,1976-04-09,Family Plot,3000000,13200000,13200000,26400000,23400000,7.8,1976,4
87,1980-05-10,Penitentiary,100000,287000,287000,574000,474000,4.74,1980,5
87,1981-06-12,Raiders of the Lost Ark,20000000,225686079,367452079,593138158,573138158,28.6569079,1981,6
87,1982-11-03,The Man From Snowy River,5000000,20659423,20659423,41318846,36318846,7.2637692,1982,11
87,1984-12-14,A Passage to India,27500000,27187653,27187653,54375306,26875306,0.9772838545454545,1984,12
87,1986-10-10,Peggy Sue Got Married,18000000,41382841,41382841,82765682,64765682,3.5980934444444443,1986,10
87,1987-07-17,Jaws 4: The Revenge,23000000,15728335,15728335,31456670,8456670,0.3676813043478261,1987,7
87,1987-07-24,La Bamba,6500000,54215416,54215416,108430832,101930832,15.68166646153846,1987,7
87,1988-05-13,Friday the 13th Part VII: The New Blood,2800000,19170001,19170001,38340002,35540002,12.692857857142856,1988,5
87,1991-01-18,White Fang,14000000,34729091,34729091,69458182,55458182,3.9612987142857143,1991,1
87,1992-08-07,Raising Cain,11000000,21171695,21171695,42343390,31343390,2.849399090909091,1992,8
87,1994-11-23,A Low Down Dirty Shame,10000000,29317886,29317886,58635772,48635772,4.8635772,1994,11
87,1995-01-13,Tales from the Crypt: Demon Knight,12000000,21089146,21089146,42178292,30178292,2.514857666666667,1995,1
87,1996-12-13,Jerry Maguire,50000000,153952592,274000000,427952592,377952592,7.55905184,1996,12
87,1998-05-08,Woo,13000000,8064972,8064972,16129944,3129944,0.24076492307692307,1998,5
87,1998-07-17,The Mask of Zorro,65000000,93828745,233700000,327528745,262528745,4.038903769230769,1998,7
87,1998-12-25,A Civil Action,60000000,56709981,56709981,113419962,53419962,0.8903327,1998,12
87,1999-10-01,Drive Me Crazy,8000000,17843379,22591451,40434830,32434830,4.05435375,1999,10
87,2000-11-10,Little Nicky,80000000,39442871,58270391,97713262,17713262,0.221415775,2000,11
87,2001-02-16,Sweet November,40000000,25288103,65754228,91042331,51042331,1.276058275,2001,2
87,2001-04-27,Driven,72000000,32616869,54616869,87233738,15233738,0.21157969444444444,2001,4
87,2001-08-31,Speedway Junky,1000000,17127,17127,34254,-965746,-0.965746,2001,8
87,2002-09-20,Trapped,30000000,6916869,6916869,13833738,-16166262,-0.5388754,2002,9
87,2002-10-18,Abandon,25000000,10719367,12219367,22938734,-2061266,-0.08245064,2002,10
87,2002-12-27,Nicholas Nickleby,10000000,1562800,1562800,3125600,-6874400,-0.68744,2002,12
87,2003-07-25,Spy Kids 3-D: Game Over,40000000,111760631,167851995,279612626,239612626,5.99031565,2003,7
87,2003-07-25,Seabiscuit,86000000,120277854,148715342,268993196,182993196,2.1278278604651164,2003,7
87,2004-06-11,The Stepford Wives,100000000,59475623,96221971,155697594,55697594,0.55697594,2004,6
87,2004-12-25,Fat Albert,45000000,48114556,48563556,96678112,51678112,1.1484024888888889,2004,12
87,2005-05-06,House of Wax,35000000,32064800,70064800,102129600,67129600,1.9179885714285714,2005,5
87,2005-09-23,Corpse Bride,30000000,53359111,114770654,168129765,138129765,4.6043255,2005,9
87,2006-05-05,The Proposition,20000000,1903434,5313608,7217042,-12782958,-0.6391479,2006,5
87,2006-12-15,The Pursuit of Happyness,55000000,162586036,307311093,469897129,414897129,7.543584163636363,2006,12
87,2007-04-13,Slow Burn,15500000,1237615,1237615,2475230,-13024770,-0.8403077419354839,2007,4
87,2007-06-15,Fantastic Four: Rise of the Silver Surfer,120000000,131921738,289480691,421402429,301402429,2.5116869083333335,2007,6
87,2007-08-10,Rush Hour 3,180000000,140125968,256585882,396711850,216711850,1.2039547222222222,2007,8
87,2007-09-14,Eastern Promises,50000000,17181265,56077088,73258353,23258353,0.46516706,2007,9
87,2007-12-14,Shotgun Stories,250000,46026,284174,330200,80200,0.3208,2007,12
87,2008-01-11,The Pirates Who Don't Do Anything: A VeggieTales Movie,15000000,12981269,13248444,26229713,11229713,0.7486475333333333,2008,1
87,2010-07-09,The Kids Are All Right,4000000,20811365,36275469,57086834,53086834,13.2717085,2010,7
87,2011-03-04,Beastly,17000000,27865571,38028230,65893801,48893801,2.8761059411764704,2011,3
87,2011-09-30,Courageous,2000000,34522221,35185884,69708105,67708105,33.8540525,2011,9
87,2012-03-30,Wrath of the Titans,150000000,83670083,305270083,388940166,238940166,1.59293444,2012,3
87,2012-04-20,The Lucky One,25000000,60457138,96633833,157090971,132090971,5.28363884,2012,4
87,2012-09-14,The Master,37500000,16247159,50647416,66894575,29394575,0.7838553333333333,2012,9
87,2013-04-26,The Big Wedding,32500000,21819348,48425971,70245319,37745319,1.1613944307692308,2013,4
87,2015-01-23,Song One,6000000,32251,437089,469340,-5530660,-0.9217766666666667,2015,1
87,2016-04-22,Unsullied,1500000,510957,510957,1021914,-478086,-0.318724,2016,4
87,2016-12-02,Jackie,9000000,13960394,36588512,50548906,41548906,4.616545111111111,2016,12
87,2017-06-16,Rough Night,20000000,22105643,46844357,68950000,48950000,2.4475,2017,6
88,1952-07-24,High Noon,730000,8000000,8000000,16000000,15270000,20.91780821917808,1952,7
88,1964-04-08,From Russia With Love,2000000,24800000,78900000,103700000,101700000,50.85,1964,4
88,1966-07-16,Torn Curtain,3000000,13000000,13000000,26000000,23000000,7.666666666666667,1966,7
88,1978-01-01,The Boys from Brazil,12000000,19000000,19000000,38000000,26000000,2.1666666666666665,1978,1
88,1978-04-13,F.I.S.T,11000000,20388920,20388920,40777840,29777840,2.7070763636363635,1978,4
88,1979-08-17,Life of Brian,4000000,20182359,20468305,40650664,36650664,9.162666,1979,8
88,1980-07-04,Airplane!,3500000,83453539,83453539,166907078,163407078,46.68773657142857,1980,7
88,1981-05-22,The Four Seasons,6500000,42488161,42488161,84976322,78476322,12.073280307692308,1981,5
88,1984-03-16,The Ice Pirates,9000000,13075390,13075390,26150780,17150780,1.9056422222222222,1984,3
88,1988-12-21,Dangerous Liaisons,14000000,34700000,34700000,69400000,55400000,3.9571428571428573,1988,12
88,1991-10-23,House Party 2,5000000,19438638,19438638,38877276,33877276,6.7754552,1991,10
88,1993-12-25,Tombstone,25000000,56505065,56505065,113010130,88010130,3.5204052,1993,12
88,1994-07-01,Baby's Day Out,50000000,16581575,16581575,33163150,-16836850,-0.336737,1994,7
88,1994-08-31,Killing Zoe,1500000,418953,418953,837906,-662094,-0.441396,1994,8
88,1995-06-10,Pocahontas,55000000,141579773,347100000,488679773,433679773,7.885086781818182,1995,6
88,1996-07-24,A Time to Kill,40000000,108766007,152266007,261032014,221032014,5.52580035,1996,7
88,1998-12-04,Psycho,20000000,21541218,37226218,58767436,38767436,1.9383718,1998,12
88,2000-08-04,Space Cowboys,65000000,90454043,128874043,219328086,154328086,2.374278246153846,2000,8
88,2000-08-25,The Crew,23000000,13019253,13019253,26038506,3038506,0.13210895652173912,2000,8
88,2000-12-22,Cast Away,85000000,233632142,427230516,660862658,575862658,6.7748548,2000,12
88,2001-10-19,From Hell,35000000,31598308,68712365,100310673,65310673,1.8660192285714285,2001,10
88,2001-12-21,The Majestic,72000000,27796042,37306334,65102376,-6897624,-0.09580033333333333,2001,12
88,2001-12-26,Gosford Park,18000000,41300105,41300105,82600210,64600210,3.5889005555555555,2001,12
88,2003-08-22,Marci X,20000000,1646664,1646664,3293328,-16706672,-0.8353336,2003,8
88,2004-02-06,The Lost Skeleton of Cadavra,100000,110536,110536,221072,121072,1.21072,2004,2
88,2005-04-22,Madison,15500000,517262,517262,1034524,-14465476,-0.9332565161290323,2005,4
88,2006-09-15,Artie Lange's Beer League,2800000,475000,475000,950000,-1850000,-0.6607142857142857,2006,9
88,2006-12-25,Notes on a Scandal,27500000,17510118,50578411,68088529,40588529,1.4759465090909092,2006,12
88,2007-04-05,The Reaping,40000000,25126214,62226214,87352428,47352428,1.1838107,2007,4
88,2007-06-08,Surf's Up,100000000,58867694,145395745,204263439,104263439,1.04263439,2007,6
88,2007-10-03,Lake of Fire,6000000,25317,26007,51324,-5948676,-0.991446,2007,10
88,2007-11-16,Beowulf,150000000,82280579,195080579,277361158,127361158,0.8490743866666667,2007,11
88,2008-01-23,U2 3D,15000000,12898847,26170402,39069249,24069249,1.6046166,2008,1
88,2008-10-10,The Express,37500000,9793406,9813309,19606715,-17893285,-0.47715426666666666,2008,10
88,2009-09-25,Surrogates,80000000,38577772,119668350,158246122,78246122,0.978076525,2009,9
88,2010-03-05,Brooklyn's Finest,17000000,27163593,39233233,66396826,49396826,2.9056956470588235,2010,3
88,2010-04-16,The Joneses,10000000,1475746,3541565,5017311,-4982689,-0.4982689,2010,4
88,2011-09-16,Straw Dogs,25000000,10324441,11253821,21578262,-3421738,-0.13686952,2011,9
88,2012-02-24,Wanderlust,32500000,17288155,24159934,41448089,8948089,0.27532581538461537,2012,2
88,2012-06-29,Magic Mike,7000000,113721571,170549753,284271324,277271324,39.610189142857145,2012,6
88,2012-07-06,Savages,45000000,47323100,82513490,129836590,84836590,1.8852575555555555,2012,7
88,2012-11-21,Life of Pi,120000000,124987022,620912003,745899025,625899025,5.215825208333333,2012,11
88,2013-08-30,One Direction: This is Us,10000000,28873374,68541786,97415160,87415160,8.741516,2013,8
88,2013-09-18,Enough Said,8000000,17550872,25621449,43172321,35172321,4.396540125,2013,9
88,2014-08-15,Nightlights,250000,21147,21147,42294,-207706,-0.830824,2014,8
88,2015-02-13,Hits,1000000,15156,15156,30312,-969688,-0.969688,2015,2
88,2015-12-25,Daddyâs Home,50000000,150357137,242757137,393114274,343114274,6.86228548,2015,12
88,2015-12-25,Joy,60000000,56451232,101134059,157585291,97585291,1.6264215166666667,2015,12
88,2016-07-01,The Legend of Tarzan,180000000,126643061,348902025,475545086,295545086,1.6419171444444445,2016,7
88,2016-09-09,Robinson Crusoe,13000000,8005586,42446455,50452041,37452041,2.880926230769231,2016,9
88,2018-05-11,Life of the Party,30000000,53059911,65759911,118819822,88819822,2.9606607333333335,2018,5
88,2018-08-31,Kin,30000000,5718096,10096821,15814917,-14185083,-0.4728361,2018,8
88,2019-03-22,Us,20000000,175006930,254210310,429217240,409217240,20.460862,2019,3
89,1939-08-25,The Wizard of Oz,2777000,34063405,34305476,68368881,65591881,23.61969067338855,1939,8
89,1970-01-01,M*A*S*H,3500000,81600000,81600000,163200000,159700000,45.628571428571426,1970,1
89,1975-01-01,Barry Lyndon,11000000,20000000,20169934,40169934,29169934,2.651812181818182,1975,1
89,1978-12-15,Superman,55000000,134218018,300200000,434418018,379418018,6.898509418181818,1978,12
89,1980-01-01,Dressed to Kill,6500000,31899000,31899000,63798000,57298000,8.815076923076923,1980,1
89,1982-05-21,Mad Max 2: The Road Warrior,2000000,24600832,24600832,49201664,47201664,23.600832,1982,5
89,1982-07-09,Tron,17000000,26918576,26918576,53837152,36837152,2.1668912941176472,1982,7
89,1983-04-15,Flashdance,7000000,90463574,201463574,291927148,284927148,40.70387828571429,1983,4
89,1984-06-01,Once Upon a Time in America,30000000,5321508,5575648,10897156,-19102844,-0.6367614666666667,1984,6
89,1990-10-19,Quigley Down Under,20000000,21413105,21413105,42826210,22826210,1.1413105,1990,10
89,1992-07-01,A League of Their Own,40000000,107533925,132440066,239973991,199973991,4.999349775,1992,7
89,1992-11-20,Home Alone 2: Lost in New York,20000000,173585516,358994850,532580366,512580366,25.6290183,1992,11
89,1994-04-13,Serial Mom,13000000,7881335,7881335,15762670,2762670,0.21251307692307692,1994,4
89,1994-09-30,The River Wild,45000000,46815000,94215000,141030000,96030000,2.134,1994,9
89,1994-10-14,Hoop Dreams,700000,7768371,11768371,19536742,18836742,26.90963142857143,1994,10
89,1996-12-20,Marvin's Room,23000000,12803305,12803305,25606610,2606610,0.11333086956521739,1996,12
89,1997-12-24,As Good as it Gets,50000000,148478011,314111923,462589934,412589934,8.25179868,1997,12
89,1998-01-16,Half Baked,8000000,17394881,17394881,34789762,26789762,3.34872025,1998,1
89,1999-03-26,Doug's 1st Movie,5000000,19421271,19421271,38842542,33842542,6.7685084,1999,3
89,1999-08-13,Brokedown Palace,25000000,10115014,11115766,21230780,-3769220,-0.1507688,1999,8
89,1999-10-08,Superstar,14000000,30628981,30628981,61257962,47257962,3.3755687142857145,1999,10
89,1999-11-12,The Messenger: The Story of Joan of Arc,50000000,14271297,14271297,28542594,-21457406,-0.42914812,1999,11
89,2000-03-22,Romeo Must Die,25000000,55973336,91036760,147010096,122010096,4.88040384,2000,3
89,2000-09-01,Highlander: Endgame,15000000,12801190,12801190,25602380,10602380,0.7068253333333333,2000,9
89,2000-09-22,The Specials,1000000,12996,12996,25992,-974008,-0.974008,2000,9
89,2001-06-08,Evolution,80000000,38311134,98341932,136653066,56653066,0.708163325,2001,6
89,2002-01-11,Orange County,18000000,41059716,43308707,84368423,66368423,3.687134611111111,2002,1
89,2002-05-17,The Believer,1500000,406035,1840248,2246283,746283,0.497522,2002,5
89,2002-09-06,Swimfan,10000000,28564995,34084228,62649223,52649223,5.2649223,2002,9
89,2002-12-06,Equilibrium,20000000,1190018,5345869,6535887,-13464113,-0.67320565,2002,12
89,2003-11-07,Elf,32000000,173840591,220678483,394519074,362519074,11.3287210625,2003,11
89,2004-05-14,Breakin' All the Rules,9000000,12232382,12512317,24744699,15744699,1.749411,2004,5
89,2004-06-25,Two Brothers,72000000,19176754,62176754,81353508,9353508,0.12990983333333334,2004,6
89,2005-03-11,The Upside of Anger,12000000,18761993,28915761,47677754,35677754,2.9731461666666665,2005,3
89,2006-06-23,Krrish,10000000,1430721,32430721,33861442,23861442,2.3861442,2006,6
89,2006-11-17,Happy Feet,85000000,198000317,385000317,583000634,498000634,5.858830988235294,2006,11
89,2006-12-08,Blood Diamond,100000000,57377916,171377916,228755832,128755832,1.28755832,2006,12
89,2007-02-16,Ghost Rider,120000000,115802596,229545589,345348185,225348185,1.8779015416666667,2007,2
89,2007-10-19,Rendition,27500000,9736045,26939925,36675970,9175970,0.33367163636363634,2007,10
89,2008-11-21,Twilight,37000000,192769854,402280159,595050013,558050013,15.082432783783783,2008,11
89,2010-02-26,The Yellow Handkerchief,15500000,318623,318623,637246,-14862754,-0.9588873548387097,2010,2
89,2010-04-02,Don McKay,6000000,13722,13722,27444,-5972556,-0.995426,2010,4
89,2010-05-14,Letters to Juliet,30000000,53032453,82148538,135180991,105180991,3.5060330333333334,2010,5
89,2011-01-07,Season of the Witch,40000000,24827228,91126600,115953828,75953828,1.8988457,2011,1
89,2011-11-23,Hugo,180000000,73864507,180047784,253912291,73912291,0.41062383888888887,2011,11
89,2012-05-11,Dark Shadows,150000000,79727149,238202668,317929817,167929817,1.1195321133333334,2012,5
89,2012-08-17,ParaNorman,60000000,56003051,108119662,164122713,104122713,1.73537855,2012,8
89,2014-03-21,Cheap Thrills,100000,59424,59424,118848,18848,0.18848,2014,3
89,2014-04-18,A Haunted House 2,4000000,17329487,21206861,38536348,34536348,8.634087,2014,4
89,2014-06-06,Test,250000,18823,18823,37646,-212354,-0.849416,2014,6
89,2014-12-19,Annie,65000000,85911262,139829625,225740887,160740887,2.472936723076923,2014,12
89,2018-06-01,Upgrade,3000000,11977130,16553285,28530415,25530415,8.510138333333334,2018,6
89,2018-06-01,Adrift,35000000,31445011,57897191,89342202,54342202,1.5526343428571427,2018,6
90,1946-08-15,Notorious,2000000,24464742,24464742,48929484,46929484,23.464742,1946,8
90,1977-11-16,Close Encounters of the Third Kind,20000000,169100479,340800479,509900958,489900958,24.4950479,1977,11
90,1993-04-02,The Adventures of Huck Finn,6500000,24103594,24103594,48207188,41707188,6.416490461538461,1993,4
90,1993-05-28,Cliffhanger,65000000,84049211,255000000,339049211,274049211,4.216141707692308,1993,5
90,1994-06-03,Renaissance Man,40000000,24172899,24172899,48345798,8345798,0.20864495,1994,6
90,1995-09-27,To Die For,20000000,21284514,27688744,48973258,28973258,1.4486629,1995,9
90,1995-11-03,Fair Game,50000000,11497497,26097497,37594994,-12405006,-0.24810012,1995,11
90,1996-06-28,The Nutty Professor,55000000,128814019,273814019,402628038,347628038,6.320509781818182,1996,6
90,1996-07-05,Phenomenon,32000000,104636382,152036382,256672764,224672764,7.021023875,1996,7
90,1997-08-13,The Full Monty,3500000,45950122,261249383,307199505,303699505,86.77128714285715,1997,8
90,1997-11-14,The Jackal,60000000,54956941,159356941,214313882,154313882,2.5718980333333334,1997,11
90,1998-12-25,Patch Adams,50000000,135014968,202173000,337187968,287187968,5.74375936,1998,12
90,1999-01-08,The Sticky Fingers of Time,250000,18195,20628,38823,-211177,-0.844708,1999,1
90,1999-08-04,Dick,13000000,6276869,6276869,12553738,-446262,-0.03432784615384615,1999,8
90,2001-04-06,Blow,30000000,52990775,83282296,136273071,106273071,3.5424357,2001,4
90,2001-12-07,Ocean's Eleven,85000000,183417150,450728529,634145679,549145679,6.4605374,2001,12
90,2002-08-16,Possession,25000000,10103647,14805812,24909459,-90541,-0.00362164,2002,8
90,2002-09-27,Wasabi,15300000,81525,7000000,7081525,-8218475,-0.5371552287581699,2002,9
90,2004-01-09,Chasing Liberty,23000000,12189514,12291975,24481489,1481489,0.0644125652173913,2004,1
90,2004-07-30,The Village,71682975,114197520,257641634,371839154,300156179,4.187272905456282,2004,7
90,2005-06-24,Rize,700000,3278611,4857731,8136342,7436342,10.623345714285714,2005,6
90,2005-08-26,The Brothers Grimm,80000000,37899638,105299638,143199276,63199276,0.78999095,2005,8
90,2006-03-03,Dave Chappelle's Block Party,3000000,11718595,12051924,23770519,20770519,6.923506333333333,2006,3
90,2006-03-03,Aquamarine,12000000,18597342,22978953,41576295,29576295,2.46469125,2006,3
90,2006-06-06,The Omen,25000000,54607383,119295584,173902967,148902967,5.95611868,2006,6
90,2006-10-06,Employee of the Month,10000000,28444855,38364855,66809710,56809710,5.680971,2006,10
90,2008-02-15,Diary of the Dead,2750000,952620,5394447,6347067,3597067,1.3080243636363635,2008,2
90,2008-03-07,Snow Angels,1500000,402858,414404,817262,-682738,-0.45515866666666666,2008,3
90,2008-08-15,Mirrors,35000000,30691439,77220596,107912035,72912035,2.083201,2008,8
90,2009-01-30,New in Town,8000000,16734283,29937909,46672192,38672192,4.834024,2009,1
90,2010-08-20,Lottery Ticket,17000000,24719879,24719879,49439758,32439758,1.9082210588235293,2010,8
90,2010-09-03,16 to Life,1000000,11574,11574,23148,-976852,-0.976852,2010,9
90,2010-09-24,Legend of the Guardians: The Owls of Ga'Hoole,100000000,55675313,139716717,195392030,95392030,0.9539203,2010,9
90,2011-04-29,Dylan Dog: Dead of Night,20000000,1186538,6093725,7280263,-12719737,-0.63598685,2011,4
90,2011-08-12,Glee: The 3D Concert Movie,9000000,11862398,17462398,29324796,20324796,2.2583106666666666,2011,8
90,2011-10-28,Anonymous,27500000,4463292,15815509,20278801,-7221199,-0.26258905454545456,2011,10
90,2012-01-13,The Iron Lady,14000000,29959436,115592104,145551540,131551540,9.396538571428572,2012,1
90,2012-07-27,Killer Joe,10000000,1291645,4659110,5950755,-4049245,-0.4049245,2012,7
90,2013-01-11,Quartet,11000000,18388357,56178935,74567292,63567292,5.778844727272728,2013,1
90,2013-03-01,The Last Exorcism Part II,4000000,15179303,25448707,40628010,36628010,9.1570025,2013,3
90,2013-06-28,White House Down,150000000,73103784,205440387,278544171,128544171,0.85696114,2013,6
90,2013-07-26,Blue Jasmine,18000000,33404871,102912961,136317832,118317832,6.5732128888888885,2013,7
90,2013-08-07,We're the Millers,37000000,150394119,267816276,418210395,381210395,10.302983648648649,2013,8
90,2014-03-21,Godâs Not Dead,1150000,60755732,63777092,124532824,123382824,107.28941217391305,2014,3
90,2014-05-23,Blended,45000000,46290741,127990741,174281482,129281482,2.872921822222222,2014,5
90,2014-06-19,The Past is a Grotesque Animal,100000,20056,20056,40112,-59888,-0.59888,2014,6
90,2016-02-19,Race,5000000,19115191,23745772,42860963,37860963,7.5721926,2016,2
90,2016-06-10,The Conjuring 2: The Enfield Poltergeist,40000000,102470008,311262102,413732110,373732110,9.34330275,2016,6
90,2017-01-20,The Founder,15000000,12786053,24403192,37189245,22189245,1.479283,2017,1
90,2017-07-21,Valerian and the City of a Thousand Planets,180000000,40479370,215098356,255577726,75577726,0.4198762555555556,2017,7
90,2017-09-22,Stronger,30000000,4211129,8786752,12997881,-17002119,-0.5667373,2017,9
90,2018-03-16,I Can Only Imagine,7000000,83482352,85604221,169086573,162086573,23.155224714285715,2018,3
90,2018-04-13,Rampage,120000000,101028233,428056280,529084513,409084513,3.409037608333333,2018,4
91,1967-08-02,In the Heat of the Night,2000000,24379978,24407647,48787625,46787625,23.3938125,1967,8
91,1974-12-17,The Front Page,4000000,15000000,15000000,30000000,26000000,6.5,1974,12
91,1979-10-17,The Black Stallion,2700000,37799643,37799643,75599286,72899286,26.999735555555556,1979,10
91,1981-09-18,Mommie Dearest,5000000,19032000,25032000,44064000,39064000,7.8128,1981,9
91,1985-10-25,Krush Groove,3000000,11052713,11052713,22105426,19105426,6.3684753333333335,1985,10
91,1987-05-20,Beverly Hills Cop II,20000000,153665036,276665036,430330072,410330072,20.5165036,1987,5
91,1989-11-08,Henry V,9000000,10161099,10176701,20337800,11337800,1.2597555555555555,1989,11
91,1993-07-23,Poetic Justice,14000000,27450453,27450453,54900906,40900906,2.921493285714286,1993,7
91,1996-04-19,Mrs. Winterbourne,25000000,10039566,10039566,20079132,-4920868,-0.19683472,1996,4
91,1996-12-13,Mars Attacks!,80000000,37771017,101371017,139142034,59142034,0.739275425,1996,12
91,1997-11-07,Starship Troopers,100000000,54768952,121100000,175868952,75868952,0.75868952,1997,11
91,1998-05-15,Quest for Camelot,40000000,22772500,38172500,60945000,20945000,0.523625,1998,5
91,1998-06-26,Doctor Dolittle,71500000,144156605,294156605,438313210,366813210,5.130254685314686,1998,6
91,1999-01-22,Gloria,30000000,4167493,4967493,9134986,-20865014,-0.6955004666666667,1999,1
91,1999-02-12,Message in a Bottle,30000000,52880016,52880016,105760032,75760032,2.5253344,1999,2
91,1999-04-09,Go!,6500000,16875273,28383441,45258714,38758714,5.962879076923077,1999,4
91,1999-11-10,Light It Up,13000000,5871603,5871603,11743206,-1256794,-0.09667646153846154,1999,11
91,2001-08-10,Session 9,1500000,378176,1619602,1997778,497778,0.331852,2001,8
91,2001-11-09,Keeping it Real: The Adventures of Greg Walloch,100000,1358,1358,2716,-97284,-0.97284,2001,11
91,2001-11-21,Out Cold,11000000,13906394,14786394,28692788,17692788,1.6084352727272728,2001,11
91,2003-06-27,Charlie's Angels: Full Throttle,120000000,100814328,227200000,328014328,208014328,1.7334527333333334,2003,6
91,2003-09-05,Dickie Roberts: Former Child Star,17000000,22734486,23734486,46468972,29468972,1.7334689411764705,2003,9
91,2003-12-25,Paycheck,60000000,53789313,98819789,152609102,92609102,1.5434850333333334,2003,12
91,2004-07-23,The Bourne Supremacy,85000000,176087450,311001124,487088574,402088574,4.730453811764706,2004,7
91,2005-10-07,Waiting...,1125000,16124543,18673274,34797817,33672817,29.93139288888889,2005,10
91,2006-02-10,Final Destination 3,25000000,54098051,112798051,166896102,141896102,5.67584408,2006,2
91,2006-03-31,Slither,15250000,7802450,12930343,20732793,5482793,0.35952740983606557,2006,3
91,2006-04-28,United 93,18000000,31567134,77635035,109202169,91202169,5.066787166666667,2006,4
91,2006-08-11,Half Nelson,700000,2697938,4911725,7609663,6909663,9.870947142857142,2006,8
91,2006-08-25,Idlewild,15000000,12669914,12669914,25339828,10339828,0.6893218666666666,2006,8
91,2007-01-17,Alone with Her,1000000,10787,844377,855164,-144836,-0.144836,2007,1
91,2008-08-22,The Longshots,23000000,11511323,11778396,23289719,289719,0.012596478260869565,2008,8
91,2009-08-21,Shorts,20000000,20919166,29870801,50789967,30789967,1.53949835,2009,8
91,2010-02-12,The Wolfman,150000000,62189884,142634358,204824242,54824242,0.36549494666666665,2010,2
91,2010-10-01,The Social Network,40000000,96962694,224922135,321884829,281884829,7.047120725,2010,10
91,2011-02-25,Drive Angry,50000000,10721033,41042583,51763616,1763616,0.03527232,2011,2
91,2011-03-18,Limitless,27000000,79249455,155564919,234814374,207814374,7.696828666666667,2011,3
91,2012-08-29,The Oogieloves in the BIG Balloon Adventure,20000000,1065907,1065907,2131814,-17868186,-0.8934093,2012,8
91,2013-06-12,This is the End,32000000,101470202,126539117,228009319,196009319,6.12529121875,2013,6
91,2013-11-15,Nebraska,12000000,17654912,24761360,42416272,30416272,2.534689333333333,2013,11
91,2014-06-27,Begin Again,8000000,16170632,68838736,85009368,77009368,9.626171,2014,6
91,2015-02-06,Jupiter Ascending,179000000,47482519,181982519,229465038,50465038,0.28192758659217876,2015,2
91,2015-08-21,Sinister 2,10000000,27740955,54104225,81845180,71845180,7.184518,2015,8
91,2015-11-25,Creed,37000000,109767581,173567581,283335162,246335162,6.657707081081081,2015,11
91,2016-06-17,Central Intelligence,50000000,127440871,217194805,344635676,294635676,5.89271352,2016,6
91,2016-08-12,Peteâs Dragon,65000000,76233151,137768975,214002126,149002126,2.2923404,2016,8
91,2017-01-06,Underworld: Blood Wars,35000000,30353973,81209222,111563195,76563195,2.187519857142857,2017,1
91,2017-02-10,Fifty Shades Darker,55000000,114434010,381398492,495832502,440832502,8.0151364,2017,2
91,2017-06-02,Churchill,10000000,1279681,7582196,8861877,-1138123,-0.1138123,2017,6
91,2017-06-16,All Eyez on Me,45000000,44922302,54876855,99799157,54799157,1.2177590444444444,2017,6
91,2018-04-13,Truth or Dare,3500000,41411015,95127344,136538359,133038359,38.01095971428571,2018,4
91,2019-03-15,Five Feet Apart,7000000,45729221,80504421,126233642,119233642,17.033377428571427,2019,3
92,1956-05-30,Trapeze,4000000,14400000,14400000,28800000,24800000,6.2,1956,5
92,1960-07-07,Elmer Gantry,3000000,10400000,10400000,20800000,17800000,5.933333333333334,1960,7
92,1973-12-17,Sleeper,2000000,18344729,18344729,36689458,34689458,17.344729,1973,12
92,1990-11-16,Home Alone,15000000,285761243,476684675,762445918,747445918,49.829727866666666,1990,11
92,1991-05-17,Stone Cold,25000000,9286314,9286314,18572628,-6427372,-0.25709488,1991,5
92,1991-12-06,Star Trek VI: The Undiscovered Country,27000000,74888996,96900000,171788996,144788996,5.362555407407408,1991,12
92,1993-05-26,Menace II Society,3500000,27731527,27731527,55463054,51963054,14.846586857142857,1993,5
92,1993-11-12,The Piano,7000000,40157856,40168957,80326813,73326813,10.475259,1993,11
92,1996-02-09,Broken Arrow,65000000,70645997,148345997,218991994,153991994,2.3691076,1996,2
92,1996-03-01,Up Close & Personal,60000000,51045801,100645801,151691602,91691602,1.5281933666666667,1996,3
92,1997-06-13,Ulee's Gold,2700000,9054736,15600000,24654736,21954736,8.131383703703703,1997,6
92,1997-07-25,Air Force One,85000000,172956409,315268353,488224762,403224762,4.743820729411765,1997,7
92,1997-11-07,Mad City,50000000,10561038,10561038,21122076,-28877924,-0.57755848,1997,11
92,1998-10-30,Vampires,20000000,20268825,20268825,40537650,20537650,1.0268825,1998,10
92,1999-12-03,The End of the Affair,23000000,10660147,10660147,21320294,-1679706,-0.07303069565217392,1999,12
92,2000-04-14,American Psycho,8000000,15070285,34270285,49340570,41340570,5.16757125,2000,4
92,2000-08-11,Cecil B. Demented,10000000,1276984,1953882,3230866,-6769134,-0.6769134,2000,8
92,2000-10-13,The Ladies Man,11000000,13592872,13719474,27312346,16312346,1.4829405454545455,2000,10
92,2001-08-24,Bubble Boy,13000000,5002310,5002310,10004620,-2995380,-0.23041384615384616,2001,8
92,2001-09-07,L.I.E.,700000,1140965,1140965,2281930,1581930,2.2599,2001,9
92,2002-01-18,Snow Dogs,32000000,81150692,116898028,198048720,166048720,5.1890225,2002,1
92,2002-02-22,Queen of the Damned,35000000,30307804,30307804,60615608,25615608,0.7318745142857143,2002,2
92,2002-08-02,Signs,70702619,227969295,408269295,636238590,565535971,7.998798050182554,2002,8
92,2002-09-06,City by the Sea,40000000,22433915,22433915,44867830,4867830,0.12169575,2002,9
92,2002-10-04,Jonah: A VeggieTales Movie,14000000,25571351,25608779,51180130,37180130,2.6557235714285716,2002,10
92,2003-04-25,Confidence,15000000,12212417,12212417,24424834,9424834,0.6283222666666667,2003,4
92,2003-12-05,Honey,18000000,30272254,62646763,92919017,74919017,4.162167611111111,2003,12
92,2004-01-09,My Baby's Daddy,12000000,17321573,17322212,34643785,22643785,1.8869820833333333,2004,1
92,2006-01-13,Last Holiday,45000000,38399961,43343247,81743208,36743208,0.8165157333333334,2006,1
92,2006-03-31,ATL,17000000,21170563,21170563,42341126,25341126,1.4906544705882352,2006,3
92,2006-04-07,Friends with Money,6500000,13368437,18110152,31478589,24978589,3.8428598461538463,2006,4
92,2006-04-14,The Wild,80000000,37384046,99010667,136394713,56394713,0.7049339125,2006,4
92,2006-05-12,Dead Man's Shoes,1125000,6408,414736,421144,-703856,-0.6256497777777777,2006,5
92,2007-09-21,The Assassination of Jesse James by the Coward Robert Ford,30000000,3909149,15313631,19222780,-10777220,-0.35924066666666665,2007,9
92,2008-05-23,The Children of Huang Shi,20000000,1031872,8221700,9253572,-10746428,-0.5373214,2008,5
92,2009-06-05,Land of the Lost,100000000,49438370,69548641,118987011,18987011,0.18987011,2009,6
92,2009-08-07,Julie & Julia,40000000,94125426,126646119,220771545,180771545,4.519288625,2009,8
92,2010-09-17,The Town,37000000,92186262,152566881,244753143,207753143,5.614949810810811,2010,9
92,2011-02-11,MOOZ-lum,1500000,362239,372239,734478,-765522,-0.510348,2011,2
92,2011-04-22,Madea's Big Happy Family,25000000,53345287,54160818,107506105,82506105,3.3002442,2011,4
92,2013-08-09,Elysium,120000000,93050117,286192091,379242208,259242208,2.1603517333333335,2013,8
92,2013-10-11,Captain Phillips,55000000,107136417,220648184,327784601,272784601,4.959720018181819,2013,10
92,2013-12-18,Anchorman 2: The Legend Continues,50000000,127352707,172185754,299538461,249538461,4.99076922,2013,12
92,2014-10-17,Camp X-Ray,1000000,9837,101053,110890,-889110,-0.88911,2014,10
92,2015-01-16,Still Alice,5000000,18656400,41699612,60356012,55356012,11.0712024,2015,1
92,2015-07-24,Southpaw,30000000,52421953,94156456,146578409,116578409,3.885946966666667,2015,7
92,2016-01-08,The Forest,10000000,26594261,40749230,67343491,57343491,5.7343491,2016,1
92,2016-11-04,Loving,9000000,7710234,12898064,20608298,11608298,1.2898108888888888,2016,11
92,2016-12-09,La La Land,20000000,151101803,426351163,577452966,557452966,27.8726483,2016,12
92,2017-02-17,The Great Wall,150000000,45157105,334486852,379643957,229643957,1.5309597133333332,2017,2
92,2018-07-27,Mission: ImpossibleâFallout,178000000,220159104,787456552,1007615656,829615656,4.66076211235955,2018,7
93,1971-01-01,The Andromeda Strain,6500000,12376563,12376563,24753126,18253126,2.808173230769231,1971,1
93,1972-08-11,Everything You Always Wanted to Know,2000000,18016290,18016290,36032580,34032580,17.01629,1972,8
93,1980-02-01,The Fog,1100000,21445318,21445820,42891138,41791138,37.99194363636364,1980,2
93,1984-12-05,Beverly Hills Cop,15000000,234760478,316300000,551060478,536060478,35.7373652,1984,12
93,1985-08-16,The Return of the Living Dead,4000000,14237880,14237880,28475760,24475760,6.11894,1985,8
93,1988-10-01,Halloween 4: The Return of Michael Myers,5000000,17768757,17768757,35537514,30537514,6.1075028,1988,10
93,1989-06-09,Star Trek V: The Final Frontier,30000000,52210049,70200000,122410049,92410049,3.080334966666667,1989,6
93,1991-08-23,Harley Davidson and the Marlboro Man,23000000,7018525,7018525,14037050,-8962950,-0.3896934782608696,1991,8
93,1995-04-26,Friday,3500000,27467564,27936778,55404342,51904342,14.829812,1995,4
93,1995-10-13,The Scarlet Letter,50000000,10359006,10359006,20718012,-29281988,-0.58563976,1995,10
93,1997-07-16,George Of The Jungle,55000000,105263257,174463257,279726514,224726514,4.085936618181818,1997,7
93,1999-01-15,At First Sight,40000000,22365133,22365133,44730266,4730266,0.11825665,1999,1
93,2000-10-20,The Yards,20000000,882710,2282710,3165420,-16834580,-0.841729,2000,10
93,2001-03-30,Tomcats,11000000,13558739,13558739,27117478,16117478,1.4652252727272728,2001,3
93,2001-08-24,Summer Catch,17000000,19693891,19693891,39387782,22387782,1.3169283529411764,2001,8
93,2001-10-05,Max Keeble's Big Move,12000000,17292381,17292381,34584762,22584762,1.8820635,2001,10
93,2002-02-01,Birthday Girl,13000000,4919896,8130727,13050623,50623,0.0038940769230769233,2002,2
93,2002-03-08,All About the Benjamins,14000000,25482931,25873145,51356076,37356076,2.668291142857143,2002,3
93,2002-06-07,The Divine Secrets of the Ya-Ya Sisterhood,27000000,69586544,73826768,143413312,116413312,4.311604148148148,2002,6
93,2002-10-11,Knockaround Guys,15000000,11660180,12419700,24079880,9079880,0.6053253333333334,2002,10
93,2003-12-25,Peter Pan,100000000,48417850,95255485,143673335,43673335,0.43673335,2003,12
93,2004-05-19,Shrek 2,70000000,441226247,937008132,1378234379,1308234379,18.689062557142858,2004,5
93,2004-12-29,The Merchant of Venice,30000000,3765585,18765585,22531170,-7468830,-0.248961,2004,12
93,2005-10-14,The Fog,18000000,29511112,37048526,66559638,48559638,2.6977576666666665,2005,10
93,2006-03-03,16 Blocks,45000000,36895141,65595141,102490282,57490282,1.2775618222222223,2006,3
93,2006-05-19,See No Evil,8000000,15032800,18828036,33860836,25860836,3.2326045,2006,5
93,2006-06-16,Nacho Libre,32000000,80197993,99296462,179494455,147494455,4.60920171875,2006,6
93,2006-08-09,World Trade Center,65000000,70278893,163295654,233574547,168574547,2.593454569230769,2006,8
93,2007-09-05,I Want Someone To Eat Cheese With,1500000,194568,194568,389136,-1110864,-0.740576,2007,9
93,2007-11-28,The Savages,9000000,6623082,10642023,17265105,8265105,0.918345,2007,11
93,2008-09-19,Appaloosa,20000000,20211394,27911453,48122847,28122847,1.40614235,2008,9
93,2008-11-21,Special,1000000,7202,26822,34024,-965976,-0.965976,2008,11
93,2008-12-19,The Tale of Despereaux,60000000,50877145,90482317,141359462,81359462,1.3559910333333334,2008,12
93,2009-02-06,He's Just Not That Into You,40000000,93953653,181053657,275007310,235007310,5.87518275,2009,2
93,2009-04-03,Fast & Furious,85000000,155064265,363064265,518128530,433128530,5.095629764705882,2009,4
93,2009-05-08,Next Day Air,3000000,10027047,10172519,20199566,17199566,5.733188666666667,2009,5
93,2009-09-25,Paranormal Activity,450000,107918810,194183034,302101844,301651844,670.3374311111111,2009,9
93,2009-11-06,The Fourth Kind,10000000,26218170,49486874,75705044,65705044,6.5705044,2009,11
93,2010-08-20,Nanny McPhee and the Big Bang,35000000,29197642,97799865,126997507,91997507,2.6285002,2010,8
93,2011-05-06,Jumping the Broom,7000000,37295394,38158601,75453995,68453995,9.779142142857143,2011,5
93,2011-06-10,Super 8,50000000,127004179,257972745,384976924,334976924,6.69953848,2011,6
93,2011-09-23,Dolphin Tale,37000000,72286779,96068724,168355503,131355503,3.5501487297297296,2011,9
93,2013-04-19,Oblivion,120000000,89107235,287916633,377023868,257023868,2.1418655666666666,2013,4
93,2013-07-19,The Conjuring,20000000,137400141,318000141,455400282,435400282,21.7700141,2013,7
93,2013-12-13,Tyler Perry's A Madea Christmas,25000000,52543354,52543354,105086708,80086708,3.20346832,2013,12
93,2013-12-20,Walking with Dinosaurs,80000000,36076121,123368842,159444963,79444963,0.9930620375,2013,12
93,2014-03-21,50 to 1,10000000,1069454,1069454,2138908,-7861092,-0.7861092,2014,3
93,2015-10-09,Pan,150000000,35088320,151525973,186614293,36614293,0.24409528666666666,2015,10
93,2016-05-27,X-Men: Apocalypse,178000000,155442489,542537546,697980035,519980035,2.921236151685393,2016,5
93,2017-08-04,Columbus,700000,1017107,1110511,2127618,1427618,2.0394542857142857,2017,8
93,2018-10-26,Indivisible,2700000,3511417,3588305,7099722,4399722,1.6295266666666666,2018,10
93,2019-01-25,Serenity,25000000,8547045,11367029,19914074,-5085926,-0.20343704,2019,1
94,1961-12-19,Judgment at Nuremberg,3000000,10000000,10000000,20000000,17000000,5.666666666666667,1961,12
94,1973-06-27,Live and Let Die,7000000,35400000,161800000,197200000,190200000,27.17142857142857,1973,6
94,1977-06-17,Exorcist II: The Heretic,14000000,25011000,25011000,50022000,36022000,2.573,1977,6
94,1983-03-25,The Outsiders,10000000,25697647,25697647,51395294,41395294,4.1395294,1983,3
94,1986-05-16,Top Gun,15000000,179800601,356799634,536600235,521600235,34.773349,1986,5
94,1988-11-04,They Live,4000000,13000000,13000774,26000774,22000774,5.5001935,1988,11
94,1988-11-23,Scrooged,32000000,59450353,59450353,118900706,86900706,2.7156470625,1988,11
94,1991-01-01,Straight out of Brooklyn,450000,2712293,2712293,5424586,4974586,11.054635555555556,1991,1
94,1995-07-14,The Indian in the Cupboard,45000000,35627222,35627222,71254444,26254444,0.5834320888888889,1995,7
94,1996-05-24,Spy Hard,18000000,26936265,26936265,53872530,35872530,1.9929183333333333,1996,5
94,1997-10-03,Kiss the Girls,27000000,60527873,60527873,121055746,94055746,3.483546148148148,1997,10
94,1998-12-11,A Simple Plan,17000000,16316273,16316273,32632546,15632546,0.9195615294117647,1998,12
94,1999-08-27,The Muse,15000000,11614954,11614954,23229908,8229908,0.5486605333333333,1999,8
94,1999-10-08,Naturally Native,700000,10508,10508,21016,-678984,-0.9699771428571429,1999,10
94,1999-10-22,Bats,6500000,10155691,10155691,20311382,13811382,2.124828,1999,10
94,2000-07-07,The Kid,65000000,69688384,69688384,139376768,74376768,1.1442579692307693,2000,7
94,2000-12-22,Thirteen Days,80000000,34566746,66554547,101121293,21121293,0.2640161625,2000,12
94,2002-06-28,Mr. Deeds,50000000,126293452,171269535,297562987,247562987,4.95125974,2002,6
94,2002-08-07,The Good Girl,8000000,14018296,16585503,30603799,22603799,2.825474875,2002,8
94,2003-03-07,Bringing Down the House,20000000,132675402,164675402,297350804,277350804,13.8675402,2003,3
94,2003-04-02,The Good Thief,30000000,3517797,6460758,9978555,-20021445,-0.6673815,2003,4
94,2003-04-16,Chasing Papi,9000000,6126237,12657377,18783614,9783614,1.0870682222222223,2003,4
94,2003-05-02,Owning Mahowny,10000000,1011054,1011054,2022108,-7977892,-0.7977892,2003,5
94,2003-08-01,American Wedding,55000000,104354205,126425115,230779320,175779320,3.195987636363636,2003,8
94,2004-11-12,Finding Neverland,25000000,51676606,115036108,166712714,141712714,5.66850856,2004,11
94,2005-10-14,Domino,50000000,10169202,23574057,33743259,-16256741,-0.32513482,2005,10
94,2005-12-25,Wolf Creek,1100000,16186348,29005064,45191412,44091412,40.08310181818182,2005,12
94,2006-06-09,Cars,70000000,244082982,461651246,705734228,635734228,9.081917542857143,2006,6
94,2006-09-01,Lage Raho Munna Bhai,2700000,2217561,31517561,33735122,31035122,11.49448962962963,2006,9
94,2007-05-04,"Paris, je t'aime",13000000,4857374,5175088,10032462,-2967538,-0.22827215384615385,2007,5
94,2007-09-14,In the Valley of Elah,23000000,6777741,24489150,31266891,8266891,0.35943004347826085,2007,9
94,2008-01-25,Untraceable,35000000,28687835,52649951,81337786,46337786,1.323936742857143,2008,1
94,2008-03-14,Horton Hears a Who,85000000,154529439,299477886,454007325,369007325,4.341262647058824,2008,3
94,2009-11-25,The Road,25000000,8114270,29206732,37321002,12321002,0.49284008,2009,11
94,2010-08-06,Middle Men,20000000,754301,754301,1508602,-18491398,-0.9245699,2010,8
94,2011-03-11,Mars Needs Moms,150000000,21392758,39549758,60942516,-89057484,-0.59371656,2011,3
94,2011-08-19,Amigo,1500000,184705,184705,369410,-1130590,-0.7537266666666667,2011,8
94,2011-09-02,Apollo 18,5000000,17686929,26517819,44204748,39204748,7.8409496,2011,9
94,2011-12-09,Young Adult,12000000,16311571,22750356,39061927,27061927,2.2551605833333332,2011,12
94,2013-12-06,Inside Llewyn Davis,11000000,13248209,32943247,46191456,35191456,3.1992232727272727,2013,12
94,2014-09-26,The Boxtrolls,60000000,50837305,111946251,162783556,102783556,1.7130592666666666,2014,9
94,2015-03-13,It Follows,2000000,14674077,23250755,37924832,35924832,17.962416,2015,3
94,2015-04-10,The Sisterhood of Night,1000000,6870,6870,13740,-986260,-0.98626,2015,4
94,2015-11-20,Secret in Their Eyes,20000000,20180155,32608019,52788174,32788174,1.6394087,2015,11
94,2016-02-19,The Witch,3500000,25138705,40454520,65593225,62093225,17.74092142857143,2016,2
94,2016-08-26,Mechanic: Resurrection,40000000,21218403,109738840,130957243,90957243,2.273931075,2016,8
94,2017-02-10,John Wick: Chapter Two,40000000,92029184,171350009,263379193,223379193,5.584479825,2017,2
94,2017-03-24,Power Rangers,120000000,85364450,142531552,227896002,107896002,0.89913335,2017,3
94,2017-07-28,Atomic Blonde,30000000,51573925,98345423,149919348,119919348,3.9973116,2017,7
94,2018-02-23,Game Night,37000000,69179066,117378084,186557150,149557150,4.042085135135135,2018,2
94,2018-08-10,The Meg,178000000,145443742,529530715,674974457,496974457,2.7919913314606744,2018,8
94,2019-03-15,Wonder Park,100000000,45216793,115149422,160366215,60366215,0.60366215,2019,3
95,1980-06-20,The Blues Brothers,27000000,57229890,57229890,114459780,87459780,3.2392511111111113,1980,6
95,1982-12-17,Tootsie,15000000,177200000,177200000,354400000,339400000,22.626666666666665,1982,12
95,1990-11-21,Predator 2,35000000,28317513,54768418,83085931,48085931,1.3738837428571429,1990,11
95,1995-10-13,Jade,50000000,9812870,9812870,19625740,-30374260,-0.6074852,1995,10
95,1996-12-06,Daylight,80000000,32908290,158908290,191816580,111816580,1.39770725,1996,12
95,1998-04-03,Barney's Great Adventure,15000000,11156471,11156471,22312942,7312942,0.4875294666666667,1998,4
95,1998-06-12,Can't Hardly Wait,10000000,25358996,25358996,50717992,40717992,4.0717992,1998,6
95,1998-11-04,Belly,3000000,9639390,9639390,19278780,16278780,5.42626,1998,11
95,1999-03-19,Sparkler,1000000,5494,5494,10988,-989012,-0.989012,1999,3
95,2000-01-12,My Dog Skip,7000000,34099640,35795319,69894959,62894959,8.984994142857143,2000,1
95,2000-03-17,Erin Brockovich,50000000,125548685,257805243,383353928,333353928,6.66707856,2000,3
95,2000-08-04,Saving Grace,4000000,12178602,27786849,39965451,35965451,8.99136275,2000,8
95,2000-09-08,The Way of the Gun,9000000,6047856,13061935,19109791,10109791,1.123310111111111,2000,9
95,2002-04-12,Frailty,11000000,13110448,19947280,33057728,22057728,2.005248,2002,4
95,2002-07-03,Like Mike,30000000,51432423,62432423,113864846,83864846,2.7954948666666666,2002,7
95,2002-07-19,Stuart Little 2,120000000,64956806,166000000,230956806,110956806,0.92464005,2002,7
95,2003-12-19,Mona Lisa Smile,65000000,63803100,141205169,205008269,140008269,2.153973369230769,2003,12
95,2004-01-16,Torque,40000000,21176322,46176322,67352644,27352644,0.6838161,2004,1
95,2004-07-23,Catwoman,100000000,40202379,82145379,122347758,22347758,0.22347758,2004,7
95,2004-08-13,Yu-Gi-Oh,20000000,19762690,28762690,48525380,28525380,1.426269,2004,8
95,2004-09-10,Cellular,45000000,32003620,61475984,93479604,48479604,1.0773245333333332,2004,9
95,2005-02-11,Ong-Bak,1100000,4563167,24062965,28626132,27526132,25.023756363636362,2005,2
95,2005-08-17,Supercross,30000000,3102550,3252550,6355100,-23644900,-0.7881633333333333,2005,8
95,2006-03-24,Larry the Cable Guy: Health Inspector,17000000,15680099,15680099,31360198,14360198,0.8447175294117647,2006,3
95,2006-03-31,Brick,450000,2075743,4243996,6319739,5869739,13.043864444444445,2006,3
95,2006-08-04,"Bon Cop, Bad Cop",8000000,12671300,12740705,25412005,17412005,2.176500625,2006,8
95,2007-09-07,Hatchet,1500000,175281,240396,415677,-1084323,-0.722882,2007,9
95,2007-10-19,The Ten Commandments,10000000,952820,1051907,2004727,-7995273,-0.7995273,2007,10
95,2008-09-12,Burn After Reading,37000000,60355347,168167798,228523145,191523145,5.176301216216216,2008,9
95,2009-09-25,Coco avant Chanel,23000000,6113834,50813834,56927668,33927668,1.475116,2009,9
95,2009-12-23,Alvin and the Chipmunks: The Squeakquel,70000000,219614612,443483213,663097825,593097825,8.472826071428571,2009,12
95,2010-03-12,Our Family Wedding,14000000,20255281,21410546,41665827,27665827,1.9761305,2010,3
95,2010-08-27,Takers,32000000,57744720,70587268,128331988,96331988,3.010374625,2010,8
95,2012-01-27,The Grey,25000000,51580136,81249176,132829312,107829312,4.31317248,2012,1
95,2013-11-01,About Time,12000000,15323921,89309178,104633099,92633099,7.719424916666667,2013,11
95,2014-03-21,Divergent,85000000,150947895,276014965,426962860,341962860,4.023092470588235,2014,3
95,2014-06-06,Edge of Tomorrow,178000000,100206256,370541256,470747512,292747512,1.6446489438202248,2014,6
95,2015-08-07,Ricki and the Flash,18000000,26839498,41166033,68005531,50005531,2.7780850555555556,2015,8
95,2016-01-15,Ride Along 2,40000000,90862685,124827316,215690001,175690001,4.392250025,2016,1
95,2017-04-28,JÃ¬yÃ¬ dÃ shÄ«,20000000,587470,43888531,44476001,24476001,1.22380005,2017,4
95,2017-08-04,The Dark Tower,60000000,50701325,113461527,164162852,104162852,1.7360475333333334,2017,8
95,2017-10-20,Same Kind of Different as Me,6500000,6423605,6423605,12847210,6347210,0.9764938461538462,2017,10
95,2017-11-10,Murder on the Orient Express,55000000,102826543,345922730,448749273,393749273,7.159077690909091,2017,11
95,2017-11-17,Wonder,20000000,132422809,304604712,437027521,417027521,20.85137605,2017,11
95,2018-02-02,Winchester,3500000,25091816,44378040,69469856,65969856,18.848530285714286,2018,2
95,2018-03-23,"Paul, Apostle of Christ",5000000,17547999,25529498,43077497,38077497,7.6154994,2018,3
95,2018-07-13,Eighth Grade,2000000,13539710,14341016,27880726,25880726,12.940363,2018,7
95,2018-10-12,Beautiful Boy,25000000,7634767,13031424,20666191,-4333809,-0.17335236,2018,10
95,2018-12-07,Ben is Back,13000000,3703182,9633111,13336293,336293,0.025868692307692308,2018,12
96,1962-12-25,To Kill A Mockingbird,2000000,13129846,13129846,26259692,24259692,12.129846,1962,12
96,1963-08-08,The Great Escape,4000000,11744471,11972561,23717032,19717032,4.929258,1963,8
96,1983-02-04,Videodrome,5952000,2120439,2120439,4240878,-1711122,-0.28748689516129033,1983,2
96,1987-11-25,3 Men and a Baby,15000000,167780960,167780960,335561920,320561920,21.370794666666665,1987,11
96,1988-06-22,Who Framed Roger Rabbit?,70000000,154112492,351500000,505612492,435612492,6.2230356,1988,6
96,1989-03-01,New York Stories,15000000,10763469,10763469,21526938,6526938,0.4351292,1989,3
96,1989-12-13,Glory,18000000,26593580,26593580,53187160,35187160,1.9548422222222221,1989,12
96,1991-02-14,The Silence of the Lambs,20000000,130726716,275726716,406453432,386453432,19.3226716,1991,2
96,1993-02-19,Army of Darkness,11000000,11502976,21502976,33005952,22005952,2.000541090909091,1993,2
96,1994-03-18,Naked Gun 33 1/3: The Final Insult,30000000,51041856,51041856,102083712,72083712,2.4027904,1994,3
96,1994-12-25,The Jungle Book,27000000,44342956,44342956,88685912,61685912,2.2846634074074075,1994,12
96,1995-10-27,Vampire in Brooklyn,14000000,19637147,19637147,39274294,25274294,1.8053067142857142,1995,10
96,1997-08-22,Sunday,450000,410919,450349,861268,411268,0.9139288888888889,1997,8
96,1999-05-12,Trippinâ,3000000,9017070,9017070,18034140,15034140,5.01138,1999,5
96,2002-09-27,The Tuxedo,60000000,50586000,104429625,155015625,95015625,1.58359375,2002,9
96,2002-11-27,Wes Craven Presents: They,17000000,12840842,16140842,28981684,11981684,0.7048049411764706,2002,11
96,2002-12-06,Empire,3500000,17504595,18495444,36000039,32500039,9.285725428571428,2002,12
96,2003-01-24,Darkness Falls,7000000,32539681,47289758,79829439,72829439,10.404205571428571,2003,1
96,2003-03-07,Nowhere in Africa,6500000,6173485,6173485,12346970,5846970,0.8995338461538461,2003,3
96,2004-04-23,13 Going On 30,37000000,57139723,97658712,154798435,117798435,3.1837414864864866,2004,4
96,2005-01-28,Hide and Seek,25000000,51100486,123696741,174797227,149797227,5.99188908,2005,1
96,2005-03-18,The Helixâ¦Loaded,1000000,3700,3700,7400,-992600,-0.9926,2005,3
96,2006-04-14,Scary Movie 4,40000000,90710620,178710620,269421240,229421240,5.735531,2006,4
96,2006-07-28,The Ant Bully,45000000,28142535,49610898,77753433,32753433,0.7278540666666666,2006,7
96,2006-11-03,Flushed Away,149000000,64665672,179357126,244022798,95022798,0.637736899328859,2006,11
96,2006-12-29,Miss Potter,30000000,3005605,35891257,38896862,8896862,0.2965620666666667,2006,12
96,2007-03-23,Reign Over Me,20000000,19661987,20081987,39743974,19743974,0.9871987,2007,3
96,2007-04-06,The Hoax,25000000,7164995,7164995,14329990,-10670010,-0.4268004,2007,4
96,2007-08-24,Resurrecting the Champ,13000000,3172382,3260555,6432937,-6567063,-0.5051586923076923,2007,8
96,2007-09-07,The Brothers Solomon,10000000,900926,900926,1801852,-8198148,-0.8198148,2007,9
96,2008-10-31,My Name is Bruce,1500000,173066,173066,346132,-1153868,-0.7692453333333333,2008,10
96,2009-02-27,Street Fighter: The Legend of Chun-Li,50000000,8742261,12660287,21402548,-28597452,-0.57194904,2009,2
96,2009-06-26,ChÃ©ri,23000000,2715657,2715657,5431314,-17568686,-0.7638559130434782,2009,6
96,2009-10-30,The Boondock Saints 2: All Saints Day,8000000,10273187,10629320,20902507,12902507,1.612813375,2009,10
96,2009-11-13,Fantastic Mr. Fox,40000000,21002919,47083412,68086331,28086331,0.702158275,2009,11
96,2010-12-03,All Good Things,20000000,582024,873617,1455641,-18544359,-0.92721795,2010,12
96,2011-04-01,Source Code,32000000,54712227,140428499,195140726,163140726,5.0981476875,2011,4
96,2011-09-23,Abduction,35000000,28087155,86648359,114735514,79735514,2.278157542857143,2011,9
96,2012-03-23,Serbuan maut,1100000,4105123,9297407,13402530,12302530,11.184118181818182,2012,3
96,2012-05-16,The Dictator,65000000,59650222,180148897,239799119,174799119,2.6892172153846152,2012,5
96,2012-08-17,Sparkle,10000000,24397469,24660323,49057792,39057792,3.9057792,2012,8
96,2012-09-28,Hotel Transylvania,85000000,148313048,378505812,526818860,441818860,5.197868941176471,2012,9
96,2014-02-12,RoboCop,120000000,58607007,242981799,301588806,181588806,1.51324005,2014,2
96,2014-08-15,The Expendables 3,100000000,39322544,209461378,248783922,148783922,1.48783922,2014,8
96,2014-09-26,The Equalizer,55000000,101530738,192903624,294434362,239434362,4.353352036363637,2014,9
96,2014-10-10,Addicted,5000000,17390770,17499242,34890012,29890012,5.9780024,2014,10
96,2015-10-23,The Last Witch Hunter,80000000,27367660,130818912,158186572,78186572,0.97733215,2015,10
96,2018-11-21,Creed II,50000000,115715889,213591522,329307411,279307411,5.58614822,2018,11
96,2018-12-14,If Beale Street Could Talk,12000000,14915773,19859167,34774940,22774940,1.8979116666666667,2018,12
96,2019-03-08,Captain Marvel,175000000,426525952,1123061550,1549587502,1374587502,7.854785725714286,2019,3
96,2019-05-17,The Sun is Also a Star,9000000,4950029,5434029,10384058,1384058,0.1537842222222222,2019,5
97,1933-04-07,King Kong,672000,10000000,10000650,20000650,19328650,28.762872023809525,1933,4
97,1948-08-26,Red River,3000000,9012000,9012000,18024000,15024000,5.008,1948,8
97,1963-06-12,Donovan's Reef,2686000,6600000,6600000,13200000,10514000,3.9143708116157856,1963,6
97,1980-12-05,Flash Gordon,35000000,27107960,27107960,54215920,19215920,0.5490262857142857,1980,12
97,1984-06-29,Conan the Destroyer,18000000,26400000,26400000,52800000,34800000,1.9333333333333333,1984,6
97,1986-05-23,Cobra,25000000,49042224,49042224,98084448,73084448,2.92337792,1986,5
97,1986-09-26,Down by Law,1100000,1436000,1436000,2872000,1772000,1.6109090909090908,1986,9
97,1992-02-14,Wayne's World,20000000,121697323,183097323,304794646,284794646,14.2397323,1992,2
97,1995-09-22,Showgirls,40000000,20350754,37750754,58101508,18101508,0.4525377,1995,9
97,1996-08-02,Emma,5900000,22231658,37831658,60063316,54163316,9.180223050847458,1996,8
97,1998-11-25,Home Fries,15000000,10513979,10513979,21027958,6027958,0.4018638666666667,1998,11
97,1999-07-16,Eyes Wide Shut,65000000,55691208,104267443,159958651,94958651,1.4609023230769231,1999,7
97,1999-07-30,Runaway Bride,70000000,152257509,310138178,462395687,392395687,5.6056526714285715,1999,7
97,1999-09-10,Stigmata,32000000,50041732,89441732,139483464,107483464,3.35885825,1999,9
97,1999-10-01,The Adventures of Elmo in Grouchland,17000000,11634458,11634458,23268916,6268916,0.36875976470588234,1999,10
97,2001-08-31,O (Othello),5000000,16017403,16017403,32034806,27034806,5.4069612,2001,8
97,2002-03-29,Death to Smoochy,50000000,8355815,8374062,16729877,-33270123,-0.66540246,2002,3
97,2002-11-27,Treasure Planet,100000000,38120554,91800000,129920554,29920554,0.29920554,2002,11
97,2003-07-18,Johnny English,45000000,28013509,163126676,191140185,146140185,3.2475596666666666,2003,7
97,2004-02-06,What the #$'! Do We Know,4000000,10941801,10941801,21883602,17883602,4.4709005,2004,2
97,2004-06-11,The Chronicles of Riddick,120000000,57712751,107212751,164925502,44925502,0.3743791833333333,2004,6
97,2004-11-12,Kinsey,11000000,10214647,17443529,27658176,16658176,1.5143796363636364,2004,11
97,2006-05-05,An American Haunting,14000000,16298046,30443277,46741323,32741323,2.3386659285714284,2006,5
97,2006-05-05,Wu ji,30000000,669625,35869934,36539559,6539559,0.2179853,2006,5
97,2006-08-11,Conversations with Other Women,450000,379418,1297745,1677163,1227163,2.727028888888889,2006,8
97,2007-12-07,Atonement,30000000,50980159,129779728,180759887,150759887,5.025329566666667,2007,12
97,2008-02-14,"Definitely, Maybe",7000000,32241649,55617866,87859515,80859515,11.551359285714286,2008,2
97,2008-04-04,My Blueberry Nights,10000000,866778,22198996,23065774,13065774,1.3065774,2008,4
97,2008-04-04,Nim's Island,37000000,48006762,101857425,149864187,112864187,3.0503834324324326,2008,4
97,2008-08-06,The Sisterhood of the Traveling Pants 2,27000000,44089964,44270131,88360095,61360095,2.272596111111111,2008,8
97,2008-08-22,Hamlet 2,9000000,4886216,4934104,9820320,820320,0.09114666666666667,2008,8
97,2008-09-19,My Best Friend's Girl,20000000,19219250,34787111,54006361,34006361,1.70031805,2008,9
97,2010-03-26,Chloe,13000000,3075255,11831131,14906386,1906386,0.14664507692307693,2010,3
97,2010-08-06,The Disappearance of Alice Creed,1500000,166980,1605139,1772119,272119,0.18141266666666667,2010,8
97,2010-11-26,The Kingâs Speech,15000000,138797449,430821168,569618617,554618617,36.97457446666667,2010,11
97,2011-04-29,Prom,8000000,10130219,10763183,20893402,12893402,1.61167525,2011,4
97,2011-12-02,Shame,6500000,4002293,20412841,24415134,17915134,2.7561744615384614,2011,12
97,2012-03-09,Silent House,2000000,12739737,16610760,29350497,27350497,13.6752485,2012,3
97,2012-06-08,Madagascar 3: Europe's Most Wanted,145000000,216391482,746921271,963312753,818312753,5.643536227586207,2012,6
97,2013-02-22,Dark Skies,3500000,17418667,27704111,45122778,41622778,11.892222285714286,2013,2
97,2013-06-28,Redemption,23000000,36686,13593473,13630159,-9369841,-0.40738439130434784,2013,6
97,2014-01-17,Jack Ryan: Shadow Recruit,60000000,50577412,131377412,181954824,121954824,2.0325804,2014,1
97,2014-02-21,Pompeii,80000000,23169033,108469033,131638066,51638066,0.645475825,2014,2
97,2015-03-27,Get Hard,40000000,90411453,106511453,196922906,156922906,3.92307265,2015,3
97,2015-05-15,Childless,1000000,1036,1036,2072,-997928,-0.997928,2015,5
97,2015-11-13,By the Sea,20000000,538460,3727746,4266206,-15733794,-0.7866897,2015,11
97,2016-04-15,The Jungle Book,175000000,364001123,962854547,1326855670,1151855670,6.5820324,2016,4
97,2016-10-14,Kevin Hart: What Now?,10000000,23591043,23591043,47182086,37182086,3.7182086,2016,10
97,2017-07-14,Wish Upon,12000000,14301505,23477345,37778850,25778850,2.1482375,2017,7
97,2018-02-09,Peter Rabbit,50000000,115234093,347136477,462370570,412370570,8.2474114,2018,2
97,2018-02-09,Fifty Shades Freed,55000000,100407760,371350619,471758379,416758379,7.577425072727273,2018,2
97,2019-03-15,Captive State,25000000,5958315,8993300,14951615,-10048385,-0.4019354,2019,3
97,2019-04-05,Shazam!,85000000,139606856,362899733,502506589,417506589,4.911842223529412,2019,4
98,1936-02-05,Modern Times,1500000,163245,199747,362992,-1137008,-0.7580053333333333,1936,2
98,1953-04-10,House of Wax,658000,23800000,23800000,47600000,46942000,71.34042553191489,1953,4
98,1984-08-17,Sheena,25000000,5778353,5778353,11556706,-13443294,-0.53773176,1984,8
98,1984-12-14,Dune,45000000,27447471,27447471,54894942,9894942,0.2198876,1984,12
98,1985-05-24,A View to a Kill,30000000,50327960,152627960,202955920,172955920,5.765197333333333,1985,5
98,1987-07-24,Superman IV: The Quest for Peace,17000000,11227824,11227824,22455648,5455648,0.3209204705882353,1987,7
98,1987-09-04,The Offspring,1100000,1355728,1355728,2711456,1611456,1.46496,1987,9
98,1994-04-22,The Inkwell,8000000,8864699,8864699,17729398,9729398,1.21617475,1994,4
98,1995-05-26,Casper,55000000,100328194,282300000,382628194,327628194,5.956876254545454,1995,5
98,1995-07-14,Under Siege 2: Dark Territory,60000000,50024083,104324083,154348166,94348166,1.5724694333333333,1995,7
98,1995-09-29,Halloween: The Curse of Michael Myers,5000000,15126948,15126948,30253896,25253896,5.0507792,1995,9
98,1996-02-16,City Hall,40000000,20278055,20278055,40556110,556110,0.01390275,1996,2
98,1997-08-06,Def Jam's How To Be a Player,12000000,14010363,14010363,28020726,16020726,1.3350605,1997,8
98,1999-08-06,Illuminata,10000000,836641,836641,1673282,-8326718,-0.8326718,1999,8
98,1999-09-15,American Beauty,15000000,130058047,356258047,486316094,471316094,31.421072933333335,1999,9
98,1999-10-08,Boys Don't Cry,2000000,11540607,20741000,32281607,30281607,15.1408035,1999,10
98,2000-02-04,Scream 3,40000000,89138076,161838076,250976152,210976152,5.2744038,2000,2
98,2000-03-24,Here on Earth,15000000,10494147,10845127,21339274,6339274,0.4226182666666667,2000,3
98,2000-05-12,Battlefield Earth: A Saga of the Year 3000,80000000,21471685,29725663,51197348,-28802652,-0.36003315,2000,5
98,2000-11-10,Men of Honor,32000000,48814909,82339483,131154392,99154392,3.09857475,2000,11
98,2001-03-02,The Widow of St. Pierre,13000000,3058380,3058380,6116760,-6883240,-0.52948,2001,3
98,2001-08-08,The Deep End,3000000,8823109,9981635,18804744,15804744,5.268248,2001,8
98,2002-08-09,xXx,70000000,141930000,267200000,409130000,339130000,4.844714285714286,2002,8
98,2002-09-13,Igby Goes Down,9000000,4777465,4777465,9554930,554930,0.06165888888888889,2002,9
98,2003-02-07,How to Lose a Guy in 10 Days,50000000,105807520,178890782,284698302,234698302,4.69396604,2003,2
98,2003-03-21,L\'auberge espagnole,5900000,3895664,3895664,7791328,1891328,0.3205640677966102,2003,3
98,2003-08-22,My Boss's Daughter,14000000,15549702,15549702,31099404,17099404,1.221386,2003,8
98,2005-03-18,Steamboy,20000000,468867,10468867,10937734,-9062266,-0.4531133,2005,3
98,2005-05-13,Layer Cake,6500000,2339957,11745931,14085888,7585888,1.1670596923076924,2005,5
98,2005-10-07,"Good Night, and Good Luck",7000000,31501218,56586901,88088119,81088119,11.584017,2005,10
98,2006-04-21,In Her Line of Fire,1000000,884,884,1768,-998232,-0.998232,2006,4
98,2007-05-11,Georgia Rule,20000000,18882880,20819601,39702481,19702481,0.98512405,2007,5
98,2007-11-21,Enchanted,85000000,127706877,340384141,468091018,383091018,4.506953152941176,2007,11
98,2008-03-28,Superhero Movie,35000000,26638520,73026302,99664822,64664822,1.847566342857143,2008,3
98,2008-04-25,Rogue,23000000,10452,4673377,4683829,-18316171,-0.7963552608695652,2008,4
98,2008-08-22,The House Bunny,25000000,48237389,71390601,119627990,94627990,3.7851196,2008,8
98,2010-03-12,Green Zone,100000000,35497337,97523020,133020357,33020357,0.33020357,2010,3
98,2010-10-15,Jackass 3D,20000000,117229692,171685793,288915485,268915485,13.44577425,2010,10
98,2011-12-16,Mission: ImpossibleâGhost Protocol,145000000,209397903,694713230,904111133,759111133,5.235249193103448,2011,12
98,2012-02-17,This Means War,65000000,54760791,156974557,211735348,146735348,2.257466892307692,2012,2
98,2013-04-26,Mud,10000000,21590086,31556959,53147045,43147045,4.3147045,2013,4
98,2013-05-10,Peeples,11000000,9177065,9307166,18484231,7484231,0.6803846363636363,2013,5
98,2015-06-19,Inside Out,175000000,356461711,854235992,1210697703,1035697703,5.918272588571429,2015,6
98,2015-08-07,Fantastic Four,120000000,56117548,167849187,223966735,103966735,0.8663894583333334,2015,8
98,2015-11-13,Love the Coopers,18000000,26302731,42227490,68530221,50530221,2.8072345,2015,11
98,2015-11-20,Siakh lokhamim: ha'slilim ha'gnouzim,450000,41260,42503,83763,-366237,-0.81386,2015,11
98,2016-02-12,How to be Single,37000000,46843513,100003780,146847293,109847293,2.9688457567567568,2016,2
98,2016-05-13,The Darkness,4000000,10753574,10898293,21651867,17651867,4.41296675,2016,5
98,2016-05-13,Money Monster,27000000,41012075,93466095,134478170,107478170,3.980672962962963,2016,5
98,2018-01-19,Forever My Girl,3500000,16376066,16376066,32752132,29252132,8.357752,2018,1
98,2018-02-16,Early Man,50000000,8267544,45285890,53553434,3553434,0.07106868,2018,2
98,2019-06-14,Shaft,30000000,600000,600000,1200000,-28800000,-0.96,2019,6
99,1954-08-24,The Egyptian,5000000,15000000,15000000,30000000,25000000,5.0,1954,8
99,1963-05-29,55 Days at Peking,17000000,10000000,10000000,20000000,3000000,0.17647058823529413,1963,5
99,1968-02-08,Planet of the Apes,5800000,33395426,33395426,66790852,60990852,10.515664137931035,1968,2
99,1970-06-24,Catch-22,18000000,24911670,24911670,49823340,31823340,1.7679633333333333,1970,6
99,1981-07-31,Under the Rainbow,20000000,18826490,18826490,37652980,17652980,0.882649,1981,7
99,1987-05-01,Creepshow 2,3500000,14000000,14000000,28000000,24500000,7.0,1987,5
99,1990-05-24,Back to the Future Part III,40000000,88055283,244088654,332143937,292143937,7.303598425,1990,5
99,1993-12-25,What's Eating Gilbert Grape,11000000,9170214,9170214,18340428,7340428,0.6673116363636363,1993,12
99,1994-04-29,PCU,9000000,4333569,4333569,8667138,-332862,-0.036984666666666666,1994,4
99,1994-11-11,Interview with the Vampire: The Vampire Chronicles,50000000,105264608,223564608,328829216,278829216,5.57658432,1994,11
99,1998-01-16,The Dress,2650000,16556,16556,33112,-2616888,-0.9875049056603774,1998,1
99,1998-06-19,Hav Plenty,650000,2301777,2301777,4603554,3953554,6.082390769230769,1998,6
99,1998-10-30,Living Out Loud,12000000,12905901,12905901,25811802,13811802,1.1509835,1998,10
99,1999-02-12,Blast from the Past,35000000,26613620,26613620,53227240,18227240,0.5207782857142857,1999,2
99,2000-12-08,"Crouching Tiger, Hidden Dragon",15000000,128067808,213514672,341582480,326582480,21.772165333333334,2000,12
99,2000-12-29,Shadow of the Vampire,8000000,8279017,8279017,16558034,8558034,1.06975425,2000,12
99,2002-02-22,Sex with Strangers,1100000,247740,247740,495480,-604520,-0.5495636363636364,2002,2
99,2002-05-17,About a Boy,27000000,40803000,130759651,171562651,144562651,5.3541722592592595,2002,5
99,2002-12-13,The Jimmy Show,1000000,703,703,1406,-998594,-0.998594,2002,12
99,2003-03-14,Agent Cody Banks,25000000,47545060,58240458,105785518,80785518,3.23142072,2003,3
99,2003-11-14,Looney Tunes: Back in Action,80000000,20950820,54540662,75491482,-4508518,-0.056356475,2003,11
99,2004-10-08,Raise Your Voice,15000000,10411980,14811980,25223960,10223960,0.6815973333333334,2004,10
99,2005-01-14,Racing Stripes,30000000,49772522,89955540,139728062,109728062,3.6576020666666667,2005,1
99,2005-03-24,Miss Congeniality 2: Armed and Fabulous,60000000,48478006,101382396,149860402,89860402,1.4976733666666666,2005,3
99,2005-04-22,The Game of Their Lives,20000000,375474,375474,750948,-19249052,-0.9624526,2005,4
99,2005-09-02,Underclassman,25000000,5654777,5654777,11309554,-13690446,-0.54761784,2005,9
99,2005-09-30,Capote,7000000,28750530,49924079,78674609,71674609,10.239229857142858,2005,9
99,2006-07-28,Scoop,4000000,10525717,40103262,50628979,46628979,11.65724475,2006,7
99,2007-02-09,Das Leben der Anderen,2000000,11284657,81197047,92481704,90481704,45.240852,2007,2
99,2007-05-11,The Salon,1500000,139084,139084,278168,-1221832,-0.8145546666666666,2007,5
99,2008-05-09,Poultrygeist: Night of the Chicken Dead,450000,13804,22623,36427,-413573,-0.9190511111111112,2008,5
99,2008-05-09,Speed Racer,120000000,43945766,93394462,137340228,17340228,0.1445019,2008,5
99,2009-07-31,Aliens in the Attic,45000000,25200412,59551283,84751695,39751695,0.883371,2009,7
99,2009-08-07,A Perfect Getaway,14000000,15515460,22815460,38330920,24330920,1.737922857142857,2009,8
99,2009-11-13,The Boat That Rocked,50000000,8017467,37472651,45490118,-4509882,-0.09019764,2009,11
99,2010-02-26,Cop Out,37000000,44875481,55909910,100785391,63785391,1.7239294864864865,2010,2
99,2010-04-09,Date Night,55000000,98711404,152269033,250980437,195980437,3.563280672727273,2010,4
99,2010-11-12,Skyline,10000000,21416355,68264973,89681328,79681328,7.9681328,2010,11
99,2011-09-23,Machine Gun Preacher,30000000,538690,3721988,4260678,-25739322,-0.8579774,2011,9
99,2012-01-20,Coriolanus,10000000,749641,2179623,2929264,-7070736,-0.7070736,2012,1
99,2012-02-03,Big Miracle,40000000,20157300,25268680,45425980,5425980,0.1356495,2012,2
99,2012-02-10,Safe House,85000000,126181630,208542162,334723792,249723792,2.9379269647058823,2012,2
99,2013-05-24,Before Midnight,3000000,8110621,23251930,31362551,28362551,9.454183666666667,2013,5
99,2013-05-31,The East,6500000,2274649,3027956,5302605,-1197395,-0.1842146153846154,2013,5
99,2014-06-13,How to Train Your Dragon 2,145000000,177002924,614586270,791589194,646589194,4.459235820689655,2014,6
99,2015-02-27,Focus,65000000,53862963,168065700,221928663,156928663,2.414287123076923,2015,2
99,2015-12-04,Youth,13000000,2703296,24001573,26704869,13704869,1.0542206923076922,2015,12
99,2016-07-29,Bad Moms,20000000,113257297,180998716,294256013,274256013,13.71280065,2016,7
99,2017-07-07,Spider-Man: Homecoming,175000000,334201140,880166350,1214367490,1039367490,5.9392428,2017,7
99,2017-10-20,Geostorm,100000000,33700160,220796009,254496169,154496169,1.54496169,2017,10
99,2018-04-20,I Feel Pretty,32000000,48795601,91553797,140349398,108349398,3.3859186875,2018,4
99,2018-06-08,Oceanâs 8,70000000,140218711,297115976,437334687,367334687,5.247638385714286,2018,6
100,1943-12-24,A Guy Named Joe,2627000,5363000,5363000,10726000,8099000,3.0829843928435476,1943,12
100,1965-03-07,The Train,5800000,6800000,6800000,13600000,7800000,1.3448275862068966,1965,3
100,1967-12-14,In Cold Blood,3500000,13000000,13007551,26007551,22507551,6.430728857142857,1967,12
100,1972-08-30,The Last House on the Left,87000,3100000,3100000,6200000,6113000,70.26436781609195,1972,8
100,1974-03-29,The Great Gatsby,7000000,26533200,26533200,53066400,46066400,6.580914285714286,1974,3
100,1985-04-12,Ladyhawke,20000000,18400000,18400000,36800000,16800000,0.84,1985,4
100,1985-12-18,Brazil,15000000,9929135,9932146,19861281,4861281,0.3240854,1985,12
100,1987-11-20,Teen Wolf Too,3000000,7888000,7888000,15776000,12776000,4.258666666666667,1987,11
100,1988-12-09,Twins,15000000,111936388,216600000,328536388,313536388,20.90242586666667,1988,12
100,1994-09-11,Rapa Nui,20000000,305070,305070,610140,-19389860,-0.969493,1994,9
100,1996-04-05,Faithful,13000000,2104439,2104439,4208878,-8791122,-0.6762401538461539,1996,4
100,1996-10-25,Thinner,14000000,15171475,15171475,30342950,16342950,1.1673535714285714,1996,10
100,1996-11-08,Ransom,70000000,136492681,308700000,445192681,375192681,5.359895442857143,1996,11
100,1997-11-07,Eve's Bayou,5000000,14843425,14843425,29686850,24686850,4.93737,1997,11
100,1999-06-16,Tarzan,145000000,171091819,448191819,619283638,474283638,3.2709216413793105,1999,6
100,2001-03-23,Say It Isn't So,25000000,5516708,5516708,11033416,-13966584,-0.55866336,2001,3
100,2001-11-14,The Wash,4000000,10097096,10097096,20194192,16194192,4.048548,2001,11
100,2002-12-13,Maid in Manhattan,55000000,93932896,163838217,257771113,202771113,3.686747509090909,2002,12
100,2004-01-30,The Big Bounce,50000000,6471394,6626115,13097509,-36902491,-0.73804982,2004,1
100,2004-12-08,Blade: Trinity,65000000,52397389,131353165,183750554,118750554,1.8269316,2004,12
100,2005-07-22,The Island,120000000,35818913,163018913,198837826,78837826,0.6569818833333333,2005,7
100,2005-09-02,The Transporter 2,32000000,43095856,88978458,132074314,100074314,3.1273223125,2005,9
100,2005-10-21,The Work and the Glory: American Zion,6500000,2025032,2025032,4050064,-2449936,-0.3769132307692308,2005,10
100,2006-01-27,Nanny McPhee,25000000,47279279,128745578,176024857,151024857,6.04099428,2006,1
100,2007-03-09,The Ultimate Gift,9000000,3438735,3438735,6877470,-2122530,-0.23583666666666667,2007,3
100,2007-07-20,I Now Pronounce You Chuck and Larry,85000000,119725280,185708462,305433742,220433742,2.5933381411764707,2007,7
100,2007-09-14,Across the Universe,45000000,24343673,29367143,53710816,8710816,0.1935736888888889,2007,9
100,2008-10-03,Rachel Getting Married,12000000,12796861,17475475,30272336,18272336,1.5226946666666668,2008,10
100,2009-04-10,Observe and Report,18000000,24007324,27148898,51156222,33156222,1.8420123333333334,2009,4
100,2009-06-05,My Life in Ruins,17000000,8677425,20477425,29154850,12154850,0.7149911764705882,2009,6
100,2009-12-18,Nine,80000000,19676965,53508858,73185823,-6814177,-0.0851772125,2009,12
100,2011-01-28,The Rite,37000000,33047633,97143987,130191620,93191620,2.5186924324324322,2011,1
100,2011-08-19,Spy Kids: All the Time in the World,27000000,38536376,80681183,119217559,92217559,3.415465148148148,2011,8
100,2012-05-18,Beyond the Black Rainbow,1100000,56491,56491,112982,-987018,-0.8972890909090909,2012,5
100,2012-10-19,Alex Cross,35000000,25888412,35426759,61315171,26315171,0.7518620285714286,2012,10
100,2012-12-21,The Impossible,40000000,19019882,169590606,188610488,148610488,3.7152622,2012,12
100,2013-10-04,Parkland,10000000,641439,1616353,2257792,-7742208,-0.7742208,2013,10
100,2013-10-11,Escape from Tomorrow,650000,171962,171962,343924,-306076,-0.47088615384615384,2013,10
100,2013-10-25,The Square,1500000,124244,176262,300506,-1199494,-0.7996626666666666,2013,10
100,2014-07-11,As It Is in Heaven,450000,13486,13486,26972,-423028,-0.9400622222222222,2014,7
100,2015-06-12,Me and Earl and the Dying Girl,8000000,6758416,9266180,16024596,8024596,1.0030745,2015,6
100,2015-09-18,Sicario,30000000,46889293,84393749,131283042,101283042,3.3761014,2015,9
100,2015-12-25,Point Break,100000000,28782481,126704591,155487072,55487072,0.55487072,2015,12
100,2016-04-08,Hardcore Henry,2000000,9252038,17187434,26439472,24439472,12.219736,2016,4
100,2016-07-06,Sultan,11000000,5599781,72989781,78589562,67589562,6.144505636363636,2016,7
100,2016-08-05,Suicide Squad,175000000,325100054,746059887,1071159941,896159941,5.120913948571428,2016,8
100,2016-10-14,The Accountant,40000000,86260045,152962083,239222128,199222128,4.9805532,2016,10
100,2017-12-01,The Disaster Artist,10000000,21120616,28717667,49838283,39838283,3.9838283,2017,12
100,2018-02-02,Bilal: A New Breed of Hero,30000000,490973,648599,1139572,-28860428,-0.9620142666666667,2018,2
100,2018-12-14,The Mule,50000000,103804407,170857676,274662083,224662083,4.49324166,2018,12
100,2018-12-25,Vice,60000000,47836282,70883171,118719453,58719453,0.97865755,2018,12
100,2019-01-18,Glass,20000000,111035005,245303505,356338510,336338510,16.8169255,2019,1
